<!--Saved by Quest 5.7.6404.15496-->
<asl version="550">
  <include ref="English.aslx" />
  <include ref="Core.aslx" />
  <game name="spells">
    <gameid>447e9940-d4f7-411e-be59-fba07efebfd2</gameid>
    <version>0.4</version>
    <firstpublished>2017</firstpublished>
    <defaultwebfont>Eagle Lake</defaultwebfont>
    <defaultfont>Georgia, serif</defaultfont>
    <feature_lightdark />
    <start type="script">
      game.defaultwebfont = null
    </start>
  </game>
  <object name="room">
    <inherit name="editor_room" />
    <object name="player">
      <inherit name="editor_object" />
      <inherit name="editor_player" />
      <object name="Spell Book">
        <inherit name="editor_object" />
        <inherit name="openable" />
        <feature_container />
        <look><![CDATA[It's your trusty Spell Book.{random:<br/><br/>Don't leave home without it!:It's letter-bound!:It's leather-bound, with large, friendly words...:DON'T PANIC!<br/>}]]></look>
        <take />
        <drop type="boolean">false</drop>
        <listalias>Spell Book</listalias>
        <usedefaultprefix type="boolean">false</usedefaultprefix>
        <prefix>your</prefix>
      </object>
    </object>
    <object name="Old School Scroll">
      <inherit name="editor_object" />
      <inherit name="scrolltype" />
      <object name="frotz_spell">
        <inherit name="editor_object" />
        <inherit name="spelltype" />
        <look><![CDATA[<div style="background:url('data:image/png;base64,{base64Thing.scrollImg}');border:1px solid;padding:8px;margin:4px;font-family:'Eagle Lake';font-size:large;font-weight:strong"><center><h3>FROTZ #object#</h3><b>Effect:</b>Causes an object to cast light.</center></div>]]></look>
        <alias>FROTZ Spell</alias>
        <lleps type="script">
          if (object.lightstrength = "strong") {
            msg ("You cast the ZTORF spell on " + GetDisplayName(object) + ". It's light goes out.")
            SetObjectLightstrength (object, "")
            object.enchanted = null
          }
          else {
            msg (CapFirst(GetDisplayName(object)) + " is not a light source.")
          }
        </lleps>
        <command name="frotz_spell_cmd">
          <pattern>frotz #object#</pattern>
          <script>
            if (not HasAttribute(object, "enchanted")) {
              // CloneObject (object)
              object.enchanted = NewObjectList()
              list add (object.enchanted, frotz_spell)
              // object.visible = false
              // newobj = "" + object.name + "1"
              // par = object.parent
              // object = GetObject(newobj)
              // object.parent = par
              object.enchanted = NewObjectList()
            }
            if (not ListContains(object.enchanted, frotz_spell)) {
              list add (object.enchanted, frotz_spell)
              msg ("You cast the FROTZ spell on " + GetDisplayName(object) + ".  A bright light now emanates from " + object.article + ".")
              SetObjectLightstrength (object, "strong")
            }
          </script>
        </command>
      </object>
    </object>
    <object name="llorcS Scroll">
      <inherit name="editor_object" />
      <inherit name="scrolltype" />
      <object name="lleps_spell">
        <inherit name="editor_object" />
        <inherit name="spelltype" />
        <look type="script"><![CDATA[
          msg ("LLEPS #object#<br/><br/>Reverses a spell (if the spell is reversible)")
        ]]></look>
        <lleps type="script"><![CDATA[
          foreach (cmd, ScopeCommands()) {
            if (text = cmd.spellName) {
              msg ("You cast the SPELL spell on the " +  cmd.spellName + " spell.<br/><br/>Nothing happens.")
            }
          }
        ]]></lleps>
        <command name="lleps_spell_cmd">
          <pattern>lleps #text#</pattern>
          <script><![CDATA[
            foreach (cmd, ScopeCommands()) {
              if (text = cmd.spellName) {
                // msg (cmd)
                objList = Split(cmd.name, "_")
                if (not ListItem(objList, 1) = "") {
                  object = GetObject(ListItem(objList, 0) + "_" + ListItem(objList, 1))
                }
                // msg (object)
                object.script = cmd.script
                cmd.script = object.lleps
                object.lleps = object.script
                msg ("You cast the LLEPS spell on the " +  cmd.spellName + " spell.<br/><br/>It's effect has now been reversed.")
              }
            }
          ]]></script>
        </command>
      </object>
    </object>
    <exit alias="south" to="room2">
      <inherit name="southdirection" />
      <lightsource type="boolean">false</lightsource>
    </exit>
    <object name="ball">
      <inherit name="editor_object" />
      <take />
      <bounce>You bounce it a couple of tmes, then grow bored.</bounce>
    </object>
  </object>
  <verb>
    <property>learn</property>
    <pattern>learn</pattern>
    <defaultexpression>"You can't learn " + object.article + "."</defaultexpression>
  </verb>
  <verb>
    <property>copy</property>
    <pattern>copy;scan</pattern>
    <defaultexpression>"You can't copy;scan " + object.article + "."</defaultexpression>
  </verb>
  <object name="base64Thing">
    <inherit name="editor_object" />
    <scrollImg>iVBORw0KGgoAAAANSUhEUgAAAt8AAAB7CAYAAACsGOwVAAAABmJLR0QA/wD/AP+gvaeTAAAACXBIWXMAAAsTAAALEwEAmpwYAAAAB3RJTUUH4QkJCggcsJsc7QAAAB1pVFh0Q29tbWVudAAAAAAAQ3JlYXRlZCB3aXRoIEdJTVBkLmUHAAAgAElEQVR42pS96ZPkSJLd+VM1A+AeV1519D3smWkKd0WWH/j//x1LCsm5unuqq6uy8owIdwfMVPeDmgHw7O4RbpZkVUWEhztgsEP16XtPZRpGBxhSIqWEqEIt1FrJqqgm3JykjoiwzAspKeMwchgHRAR3x8wwM9zjdQC4UatRagX3eG9RCkqtBXEniaNiHLNydzNwN2YOU2JITk7GYUwchgwO82mmlEoaRm5ubklpoFq8/+Uys8wXVITDNJKSYlYpVil1oZaCCAx5YEhxHbiDKO5QzZnnwmWZqaWiwDgod8cDt9OIqoMZxSpzMQrKxZTHS+FprpwuC5dSEVdUlKSJlBOqCcyZlxkzo5rjKqAAgrkhUgFQVQZVckokEcQdRXCDWp1iBggqCRFBqIhCykrKggGlVJbiLItQq+MI5g5iSFKSZMQ9ng+G14qoMOYRRKhmzKVQzdA8kPKAqOMU3AwHvMZzdZykCRUBHDAEEInhFU3gCdwxAREFYCmVUg3zeD9RpZZKdSOJxhxCkTYmqkpSBTTmG4qbxX05gGNUKiXmngulxJzz9pmqKV5nFcfQlFCBIWVGzaSkJARNiqqAO6UUai3xdRJSSmhKlFrIIiyljQfCpVQul4VSK07MfxfaXJD13g3HLOZSxVhvgfZzA3PwSnsfQQSqVVKK+xcVkibcDSvW7slBaOMvSMrxOQ5K/NfdUU2ISlsbcfXFLZ43xDp1UOJzNGnsC21NmzteLT67fyBtKYkg0p+coP1nceO4gqjgDuaxX6CgriiOmIBDdYcsmDmShayK10JqI4UmcG1fOYbj1uc0LLW0sRC8zaEYaFlfgziC9Mtv9xf7l7nHeHp/Bm1OSqxZcLzNu34N0p5TzNH43ZTiHswt5mIbi5RyzPv2Dr6+RmKQ+nVpvLv0T3Fvn92/LyCxh4EiKm1fYP9QuPqz3ptDG5dtDtKembQ767/bfyrrv9ehQOKy+57ibVSs3a/HCKb2njGO7VrbyNHGy7c33X3q9lylz7dt8HC3q58JgptfvaxftPt2/f1f2taUme0+q42Jt7Fez7T+3LeXuvjVNbLOg/2oSeyRsq0XM1tfJ3Fx63ip6jrGbWjiWqDtZ7J7c9++lt29eWzEss2yq+fTX+JmfQFsT3dd01/MHbbx7r9z/cRY52nfC/rXMb9jLcazl23OyPV79Diir0tR/WLQ9x8mLQYBa+s39kD9K1Pf94/pL99yF7vs13UfG7N6dV/79+zPbf91f91+HPo5H/fZ5s5+zfLXr3mdi1/ex/+PP3/r90SEv3UB/9Fn/e2r/o8/S0T+5u/8tZ/1fXX3Sv5PR6CvPXO/en/3OC+9PYO4Ll2/zxdjvdty/g8+84v7+otJ2153GCcXiMO3BQtZBRVF2wcnTWSNTSXR9+3YMPqhI4CmWCgiQkoKCpfTmXm5UGsFh8Og3CXhbkrcHhIv70a+enng6xc3vHmYOGTIUvByQd3iaLWKeWKpSm2HY62OWwRRayBmBTCyapxHZiSp5OQMKZNzQiUiG7PaNkrFxWnxEC5CRhhwkgqqTlLIQwRe1ZWLD7z7vPDT58IPHy68e5oxOfA0w/OlRqDfHoIKTEPmOA1MGaZRGZO364IhxTiPQ2YaM2MWpkE5TplpUARDqLhVRJwhR4LkFoe2e8UlDrTqQnVlvhiXxVkWozqghqaIgBQjp8Q0TRynCdXMsiwsS6GaU11YFudSCufLwjwXrDo5KcOQGYYcBxaVuhQcR5PiLohZPGckAmZRErodlCKR8xgsZlipGJBTQnOK5+Gg7lgpV5uit4BTksa9tkSg/ykOi0CtcCmVeXaW6lzmuKfiwlycUp1qxlIrdVmYcuVuVF7c3/Hq4Y7b48AhE0mhGoJRbGauFRXBFUpxqELSgTQOiGaWufLp6ZnzpYBmFhfOs7EUwyRhLvgilBmKn5FBSGOmiHCeK08no5ZEMYvkTxZSdlICL8qyxOYxThPjOOEOi1Uu8xJJgDsukaSJRAIXQXYEubUFXZEiQfXaEhSjlIIg5JQYkpKAcRw4ThPDkLiZDuQhc5kXLnOJRNeMuUQAX80pOEtZ2tyIgFBTJrmTVaEaOSljHhBJKBaJ45DIacBLYVnimi61cJ5nllpQUaZh4CZnbqcjdzc3pEFaEmMkVcbDAXfncj5jbszLwrIssbGqMuRMGnMk6vNl3TeGITONE0klxsAdFcUwxpTJw0Cxwnw5Uyz2rzwMTONIrZXz5bIGL2uSmBRJCdcYl/Nl4XS6UIpRC1yWSJTMI6GKQN8igagBAoAxDYnDNDCmnnyyJpVztTiwJWHEez6fZ6zW2H9VEMktIHGWWlmqxWG/HmSOtEPH232Pw4Aqkf1ZC4rcURG0BUxIu98ka0JXzLCWjKjmAFxKiXFoScuYMimlXWITx9kw5JiL5pSlJa/tfXEPAKPty+2KI+Hytm9b3Nea/KnEBrMmEZHk4k6P4cSFhDOkxDQMSP99Te0M6IlbS6NbMFza/ubWV1G8RlXWo9nMI2ltiU2pdTu0PUAAdwtwoR+c7lS3LXAX2YFa7T0lAn23ugZrukvq+4cEmBPfjyDPsTYcLtIj7vgs7UlHH+9dgISTUwcx4rqsPxckEuQdyLCmZG671M3X/E968rEPJtkFOQgqbcTdrhKXfTzmV9+LfcBbkKw94PZ+NT083CWsmmIvdHaBFmsAZv16W9DmLfsxX5fNOka2CzBVAxDqAZ7vkhXdZUY9sfoyqN7nyf5XEp/+ntIAkKtk64vgtQMI7Mb3P44Wt+fS55asT3H7oy1pdguw5stA2f1vJez+V0PTq+e6+93+bK/f3q8SaWlzsoMg0lbkutD6M2hrLBLyAIC1jZH0NSnxvT521bZkNe5RrhLWACwEkQAJ+4Tzniy7r/NoN2N34ENbY0MePK7PSSIkiUA7aw7EzmKxJvEVVdG2yWXVCNhVEAJpru4sNQI5vJJk4WZQHo6Jr17c8u2LxG9fw7cvJg6HA4qh7pQyU04zVhZEhGEYMHesoYtmFRcjJSUruFQUIw1wGBLTIXEYNAImt0CfxNEhkMwNTfAteRBhnuMQvSwFRBmGkWHILbitzJcFUFQyxQae58TbjzN/+OGZ798X3j85lm6R8chlXqil4rUgXjgMyv0x8eKYeXmXuD04L28Td8fMzSSMWciJ2FC9Qn8GKZKEjmKmPgHcYwP22D+txAFlbusDjwWZtsPAjZTg5u7ANI0gMJ9nzpdIiNTbBuXt/a1NMxFSq3zQNu1S65rcaDtYvSN2xASv7ZCvJZKCDUXZEIleUdkvoFIry7wEIuR5RbkRMK879CqClZQTKeuKOKSelCAgCdEBI3OuwvOl8HQ2luIUg6XEcxKcQy7cHJTjNDINyjQoWQ18QaSS1EmDkseGkBGDr6IrKpxSRqSNuSgiAy5KNWEpzrwUqgs5KzmndVvTcWD2zA8fZ/7l35/5l99/4t//9JnLqXB/zPzdr1/xi2/vuc2xxCWPHKZbqiTm4hhKMXi+zDydF07nmXmJjcGFqAb0w9/jU2upzOcL8+WE4tzeHLm7veH+7sjN4cCLW+XuJnN/d8txzOv6doxyKTydTjw/PVOqIWlgqZXPZ+ff3p75t+8+8N3bd3x4OlMqTIPy5sWBb1/f8PKYeDiOvLi943hzw8P9S46HIdarKEkzIDyfz3z49Jm379/z6fMjVo2XD/d88/VXvH75ikPOKBWrhaWUVtUR8pBIeUBVKbVGIFcqSZXj8YbjYQJ1qtWWBKYInNp6yymTVLFS8SWCflXBbGYpEdRHcJ0Y2+fQN9EdsulueC2czh+otQRI4IJVKMXWYNHcY4/SWP/zfGG+FC4Xp8wFs0pSieQgD7FXLZXn84XzXDjPyzqvCsZlqSzmlCosLpQKn08zz5fCpcDTpfD5svBcnHNtyPwKJMd8ySmRcDKVSZ2DSiSmdwcebm95uLvj7uZAynGvVp1SansGiuYc875GFWgpJaqS8xJj0PaIyMeFWsq6d8XaMqwGIlxL5bxUltISZZdYuwbnpTAvldqufQs4JfarGmiW1YoDWSEn5zgKN0Pixc3A1w8Hvn15x+ubG445k1NqwVzU78yFpZZILCyqKafzicv5RClRDRvHgeOYGYdETglzoxZr8zHjLpzOz5xOF8wqmhJJIwGZlwAp8jDgDk/PT5zOc0sKRzRlSq3M88yyxDWlrBg5guCG1BuyVS5EqAZLNUr1GG+HUuP6YzxaJSLBkBOHYdgqZm2TjURS0CGe0bxE5dg9qlki0vb5OJs1xZ7rrWwnEsDVkAaGQVfUmJbISY/Te9FAnNQCOyTGp5q3YD/uq1Tjea58Pi08z4USGRJZjGnQqJCnxJQFjdooKTWQyqUla1HFKsBsxmVemOeFUluglRIuqU0fb69v4ELLyipxBpsEch1VHcguAVq2hKcSr1GEZEYSIWdhSMKQUqz9tg+4yBo4Vu8JuK4Yb9lVzvCofOMBmFYzqkfybr6Fem6RbCahPYsARFWEQXWtiOyR4OrGXIxaiWTYDUfb+k4BXmqwFpZSqDjajvikkEUYU8SPSduZJbImvV4jSa/uJCHin93PXBTaGR6MiRIJuMa8SxpV5ABFI/i1VkFPomhjGkgrvTtOKcayFOZSe12e4gQI544SZ/LxeGSaRsoyc5pnSukJZKLnaIjGftWfW4sDIhbJZFeqVUo7l7bqHlvVu+1JKSWyaEzWUZVMbCKDKtoyUVVQSSSl3VgLXFVQqZgtFAsk0qpxSMaLg/Gzh4FvHjLfPtzw4gbubhM3U2JQI/uFQWfEngKdqY7PgRizOKKgzAwp0A0V0CGoFXlwcnaGAaZDYjoqKYEmQ6QhgI2aEYunAhW3gltQEmqFUpR5gXmG03ng46fC4+OFlCrHmwO3NwPTMMRkTxUnqCjHEb56MaJp5HAoDD+c+OnjhbIYh6zkyRjUuR0Tr+8nXt9m7o/CzaSMqTJlYcgFSY64YYuRnAjkNJG053CtROVbaaTno/3AlAFwJXmKQ6ihJLTNuVZjWWYYR5KPLCfj8+NjvJ+0gBttGVnQDkQBr/HcNSa8NMQlDy1oFqOUmWWeWZbad/5dWS3FQgeoWxYunUojgtQam6J5mzu+Uh6KLS3Dj02kUwYMC0qDgBeDlIKBIJVaZjQroiOmQi3G6fLE6bxgVskUbrNwc5uYBmE6JI6HTB5AtCCcW5bsDcGTNatG+ngEsqma1qABCs4ciYe1qhAJITGoME2KTJF0mMQmqTVTi2CX2GTvxfj6rvL80nj6AB8uFQzm0wkpma9eCG/uB27vDhxvII+ZlAeGYULzxDDdMIw3UfmoRjFjXmZKXbAaKJeVQNTny8zlfGI+n8EKh8PI7d0ND3c3HI4jtcwsZabWBU3WgsoIbvIwkdIdAsxzWatZxsTHz5l//v1P/L//+w9899MnPnx65uX9yG9/84b/53c/5xdvDtwelHHoCdMEqaDZ91U+4Ab8Bvdvgpq2VtF6+dAQTwg5EMqG9Ho7zOMsHxA5bmV2N7TNqcjN4lRyV0x60rm0HbLhPu5t/xsimWpIe6210XwqKUnbG2WjDFlt2+xxRYcjUClR1dEtgFlpUFbAbxGUpGOjGTlWfS2Xml1TSNwjQF3KwlJLC66kHZaCFed0Xng+LXx6rrx7Mv75Tx/5n398x4+PhVOJgOR0Kcw1Du5JjJsBXh4yv3x94B9+8cBvvrnlzcPAw83A65cPPLx4RR6mSF4clh6UDZmcB8yDunY5L1QvOHC+xGEWlTKYxiGAAHNqXViWOaoL5QIWdJ2yFJ4fn3n8fOYyFyrK7MrTbHw8Vd4/zfz46Zkf3j3x4blyrpF4OM50FI6jcshHbnLiJsH9WHl9q/zjr1/x21+95lff3nEzALVgZY6qgpd2aAuuGWSI4NYi0CnLMSqQRDVnGjJDGlogEPuFpvj/asa8FMxeNCTNVqqBuyF1K6c7TqnGvPSDWwOBTCkohm2OB8ghkdycLzw9nzidL1iFPB443tyhaeK0LJwuC0uNytt5ieTMakGUqGLmABoO09SCpUbtc1qCWEAqVoLqaUtFxBjaa4N+0vbKFKizi+M1kHZ1yJ1CqYJYo7OJIEl29KZeIm5rQhPSaF5WCrVEUHZenLefF/7w9pHvPpz5eIl1fTcYdwfh4Tjy8mbkxXHimAz1irY1a9WogEjCNVEQLrVynjPny8hSneLKoiOXqnw4L7x/nPk4Fz6dK8+1UlvlRRXGDKMaBxUepsSLKfFiyjwcBqYcYFVU0x1qRc3I6hxy4jAqOQlZvYXXgotGwodQPT5nbkl7rQvLPAcDQDOLZy4+8ulcefv5wrvnC8+lcK6VUiKOm1Q4ZuH1Teb1MfHioNxl5TDAlDWS7pa8dPJdNTib8VzgsTofzjPvni48LZWl0sCHSE+zKuNwE0G/+3rGJCBhJJxDVm6nzMNx5HZSJnVyO1udwqBB680NzDKEqikqxsV5Os2czwVV5XgYGSZHtLQkJpMloR7RS60lqqpjZjoMDGOKdeiCLc7lXHieK8+z8XyBzxfncXY+ngqfz5Wn5UKZFy6zROJlLb5oQJ7ZdrZEwhXnjYjEmb4slEVYUHZFvVZg6gCjrwkSAsuyIOM0ecI5JAmagCRSEpKDuKHeovQUXM7gV1orHwoJ426ofH2f+fmrxM9eCN/cKV/dK3cHJXvBbVnh+F4KtBXWD97wmHPj22orBQT6PC+FZS6REbpQ6gJW0QzTmBgnYRoT06RMUyap4WpBL4l0duWXuUWwd1lgvjiXGU5nOF+Ez0/G83NlmYWlVg6HzDQKKRU0XZiyc7wZGaeJ6pnHs/DDu5kfP1Y+PTqfnhZKNe4OmdcvM1+9Gnl15zwchAHDF0ddqTXu3qTgUnAvjJrIouRhYByDf9wR+qSRAG2cQ9+QAxGwFnCVhqYhqObICi0qCvM8M04DD/d3kSmataTHWgkv6B6d91qWmc5QjSpExqy0cljjKXuQeL0lB95pDS6NL5wicGdftpGVfuItUXBjzSLXjJIIkHrRMMqJEniCewQ9qVVcNMpJysI4AeMDF17y5w+Vf/7XP/P0eeZnr2755Vc3vDwaSU5oWkiTkEYlj45oveI1C7Lj5bbAqmXYUbbKjb/fOPxryUERSYjkVi3YBfBIK/sKpSSWAnOtFI9g+fmiPJ4m/vwj/PH7E28/z8wYN0fj//rlkX/45T0/+/k993eJwxiIfAT5E2k4kvIBFMwLJkuUQFsJP6VEzhmVRPWtdK7temtEjRGUkgh6ZiRoOQf9QhrXNO49ggtv+gZrm/dlLpyeIhhQh2FIkRhnJw9Oyhb0CQuURcXaPO28XW0Bck8kS+OKWqsytFKwy8Zp7RxyC5RVGlUiEte2UXo75nfVT2vzuHOeW9Hyap2llNY5J/IF1XSlIW6k97VS7EEJERdcbMdr9R1X2deoQ9r8Vv6SK9z/QTcUUFqAW60/x0hCXGVF6axWMMMNSlVKHXj3ceH7Hx/57odPfP/TZz6dCnMxHGHMidcvbrg/CF8/DLy5S3z7auLFbSLneE6aWwWxV+L6AcRGodE0tIoULeCJQUkpo97Qt5QQd6wWalmCflZL/DXbqDySQXNLzmy9f/PEaVE+Plf+9PaZ3//5E39+d+Hj48LzOdCy45B48+KO1w9Hbgfjbqq8vBe+fXPgq9c3jINT6qWVjzvamxvCaPH93TyxNh+i4ge11pZ8KqlRata9VLZkTNbDV1qVMirJsqMIhO5FVkqBma/VWt/pOBCnesFqIG5usMwl1lvK5BRnaD9dg6bS0GiPINQblVNWasa2L1vn6VuvngnmNVDJxsv0ap0XsVZEkQiqg9vYUFzrJfgAVqzWtq/YGqB4p1AQe3BcUI7gO+BQpH1uR8MvVTgvzrmGpmnQQE8VyBAVe6xRQCJBSDkhqelMRFB05V0HBdJZLFHSgXfPC7//6ZF/e/vEjyfn3dn5eDGKwYDz1U3i16/v+U8vD3x7k3h9qNyOlcNgqDo5Z5KOEfTPTmkV7cCQG0nB+vXFnqeacQLdX0qlVudiQR+kBl2tkHkqwrsF/vh44ofTwofTwqnEszmOiVdj5uvBuRsSd4eB25w4KkwKY+DJ4G3e4njq2pwGwWmikqmqEQQvlSK0+db0EQ2ky1lREi6wmLAYXBxOxTgX41ycYspSYZ4DsEgpgv+bUTmMgXwn8VYnEKooizmPpwvn00JKcH8zcH87cDgKY6rkpKRkJA+QcxoUtUDeVxVQA+06IGaNklSKsxhUEpeSeC7Cx4vz/lT5fHE+XWoE6VU4m7RKpbTqWsy32pgBtlPjuFurVoCzUVhkpVdtmqsNQHHk9nj0JFEGyBKCvOTS3r4J9drCSI3TIlUZqHxzW/kvv7njH391zzcPwuvbwsgz2SvLpUaAsWxizJQ8ysOyCbm0BT3BIadl+L5eaEoah1kjXgWnF+ailOr89P6Jp+cFUVoQHlQOTTANBIqflZx0DZCWYiyLU4pTKlRTzIKXW4tTTBpNIDEMipVnarmg6iHU04wOByRNVBspRfj+7Uf+9MMzp3nhqzcj33418bM3Iy/uEsdWYvLi1BILseIUC57mcj6jTYySh0QecpSGJNC34AhC7qWjtnFIWzydA9XFVA3URto41iagFeDh4R5UeH58QiUQFtXUSoK6CQsaJ7UuS8vWAq2ILNA3Tphfc7a8CXqifKy468aR60FBQ79z1pXPqCmEqUhHj9iur3HCOxfRvID2AyroRSIzJAN9wewv+dc/PvPf/8d3mMPf//orvnkzckwnxJ5JUqNMlRTJQU0ax0xqzztoJBHsS0Oaam2bZU8EbFMKRYAnK/WntoRENaFJG21JICmmiltQUiKDink3V+GyJJ7Owvc/nvnuz498PgUy+jBd+M0vX/Dzb1/x6uXE/c1ATh4UAQ1krEZKB+q4dj5vF2g2sbN3/mKjamgmpaGJUTXm4k443fUeEZT3oDGeY6B9qSVMNXQBOZHzsIrrOgXJuihOusAwnm9ObV1KcEvN6irG3JdDe8Uh5RTUsKRr8mgeAVvniSbRmA9N7G2Ng4oHvc2b0LMnt31vos9DlRXlXsV27OhYLVDyHmTtOIb0YMqNlDLoxiO8JjnulHHCmqDSaF+9nL8XjYmkRnWRQGY61UIF1Nu+2ejavVrWiLpuUQnqSfrpdOb5fKHWoNIMQ5Rex0HJEkGEeAkxdgusUspReWhzrK/nUgqlRvIW1beNT5xSbvQ+Gue6UXm80dLc8Bprvgv+cacsbS6IRjDWqi8ROEbV1UldmcNSM5cFPn0+8f7dZx6fZ2oNk4DjlLk9KLeHzO0hMQ6h5UhiDENiHAZyzpG4UtdKA7s13akYAShExcVLCP07kNGTEhFduaT9GUIE62Wp0MTtXUgoEj9bSlSpRMFKbXuatEpkXzeGiSHaaVJpTfJ7JGnexjWU1kELMI+EVLrQsfHk257WE/Ha7imSu3olXF0T1VXE1kKdBjwEKNfmLD3hCmpiqTUC/9oAmp7c7/jBnR/bz/1OH+jzz9cKUASbff1Zp0qatzOvV3Rj3jvbfFypGxZ7siXHNMCwSsKZOF8G/vx+5n9/94E/vj/zdhF+mhcuxTm48HJwfvUm859/dstvvz7y1Z1zk43UdAVWwWoYOkgNDVKcl7ZqmqpVaqkUj+pWqaFhq63aC0ptVREzo3jiVBNvnwvfP1V+fK58OBdqNbJU7ibhmxdHvjkMvFFlaLTb1NYNtbSKYVQfJCnYetxC2oGVazIVFSBNnTlvKyCHRCWDFsPlnFpcFwCAIVyqca7CuSrPNfG8FD4+XXh3LvxwMt49zZwXp2qcuccBbgbhJhuH7Iwac2IYlOM0cT8pt4NzGIyBStbCmFoVXRVvySiuWCmUOcwo8hDnl3bgso1xcWExZTbhXIRTgdPinOfKYxGeK5zOzulinIsy16iYoEoRX0XEVjzWjQVdp/YaV2cDIE0vINuW36B0uZ0OnoBBBXVvnOrgcNcWZOUsiBeSXzhgvLxJ/Jf/9BX/7R8yv341cxwUXy6kWoMPdDGKR/lT0oAOqWX7IVrTBu3bqq7f8B5RX7OslILDo+KILLSaJDBRyTydjLdvP/P5aWEpIairhYZAtuDVC6LOMGRSis1MgColhH7Bq2mCm0DWlASmlNm4XBbOc40AShNIQoeGLDfRWLWZiuB+y7IItpyw8sTdUXj1cuLV3cRhAm1JTjgtOMU8eNtmK5eoB6qt+BmlQIlAc2h0jj5eUSRoh5rseO2yJTG1NDQJIUkTYC0Ll8vM8TgxjGNsCI0zkbSPuW4q8lpZ5jkC+Fb2cXfKErys2kVSraS6OgU0AYs38WoEvDHmOcfBLN5L9ayHjbRFFYFZ2wxSP7gDUmn5wCp0E2JzqT5yrgNv35559+HC/d2Br97ckXXBy1NLooJOgybSmDkcpxCbZekxFLUUqi+NWxfl4FoqIsrQDmztzgPSxShxQK8LrVN6zIJLKg158RQ4TeO2t9iR6sbT6czz88xSFEkT43gTfDtRVAsiBTzWQkqZw3BAUiRtw5AiGVmDsS3Tdu/VqnqF8OeUmaZj6C9SZp4XljKzLEscwKv4e8vg+3PqH9G5m2Z/RdHdnHk6ryTlHMGOBwcal1VAlFrwHnxZX0WkK0TVA17rbhpBh+ruMS7WXHECerMWHAVC2RKuhlZXi4CgwXOreDxi4C35GJJuCUtDwI1dtcb7HGwC1/X7vgYP0pLI1UFC5UqPJE08KR3V32Hs1tyiVGVdk911RtrhmNff7Yl2Wela0pKREEktQZupNSoXJuu+oxqJkDcqTBJBc9PApKAZlBJUhlWstgsu+xgFf1+bKH4bB91VslbXENtCMLe68Yh7suZ9BW17WsqZPAZS6E34VEpPtFg1HyF6CP54brQHt0JdlvZZwfsYx8w4DaQegO8cKbRzR1vQVpsYuvOrpQm1rit8Rim1CXiD7tSkkz4AACAASURBVBUJoKz0FNHUUGha4mqr/kBUGIZxFWuWUnCHIYfYfUhRdVtKCSqZ1ZYEVcxroKtZW1WwnSNpX6G8dqroyTRdr+MelM1W0kd2KHELfmupTVAW+0cHb7pYr1dC+/esVWC6w5itYvnNtScQ//qFi4avVZZNXOordcc9WGK+ggU7EetObhni0xTnvjvVB4poq7xFgummzDbw6Rn++NOFf/r+M//67sQPT5UnoFjlboCvbpSvj8qvXwz8/dd3/OLhwF0GtxnzeA61VYkDsGzaJt/qqGYW+qY2Z2qjjBbr2hwYZERUMU08i/Lnp5l/fvuZP7y78GmJ6vFtznx9o/zsoHx7k3gYUjgPrA5gwVxAaElxIO7im0uTaoBQPcuSHW/dvRsobOBbrONOqciNvtI47ak9p07NBIoLpVWrihnPJry7FN6fne+fCn/8tPDvHwsf5spCcOEP2Xg5RqJzn42HSfjqPvHimLg9DIxqZOqqWSkuFJzzpTDPRq2h77i7G7i7H5tGJ/j3OWdqMS7nC0tpVWBSCHGrs5TK0kjGrhNLHfj4VPjxw4lPzzOzJGaHizmFRPVEtaAwFjeWpYabW6fTtn3RVwewJtQUieB70ET2FGiaRjkYHKkxWSYRbrTw+gZ+9+2B3/36yK++PnB3KIif8WJ4qfFgVZEcDnP0YKQIdTYujzPPpws1DwzjyDgM6+L3Nlut+lrS7xuGuTO7cDGjloKuYU1s0lmkcctSQ3BGUsorP7Pa0ja2OJQj8CPQtBRBVK1GWQqlBDm/VMddmasFab9xCot7cJFdg2fZNpLjNHJ3l3nx4oYxDZwfn1nmM2MW7m6UmyMMowVdQAQlB2/VHXyJUuAumEwomxg+FkvyfVm8IlhLKGSlgri1BCptB3Iv5ZcleJi9zNqRk9gcrq2AtAktytKFU4XS0JC9Qtt3tJBApvXK5Sxym2bXtFNepxQbbkf8owrS+Gcr5z2Sm3ATaIdi1hUVUUkrauvWvOyUSITEGkccvFYiK3M8hTBMhhzz08CWSq3zWgLFjeqFlCLQHoa8fqY7iCviGtSJ1MWwgUSmnFahzpdWU9K4gP1csjaHO8XDTLlcKmVJPD0aH96d0JT41W8eOBxhGIddoXgAH5kvwscPz7x/9xkz5+HFPa9fveLmdkBbKTQ1ykZsoL4JVzuq1w5Y1YRqR+Kay0dZ1k16tWTSzfKuJ145Te01sqLGfmXvJOQ8hBXgsjS0WtfgNaVMGsKRKOZlFwFtThYhbu0CIHaOD9KoAr6W04OyUtdrtKXgS9ms8rQHq0tD/jqlghY4NkTdrFlFxutLKbHraBckt+RPY0da71V1Zzaw2QzGr6aNy733AGhI97WVoLCzlNhZeG3Wd6FPiMBJOkVmpXXZ6i6i3e7SLKh7DV3yulW0egCcc1pt+IJ6Y2E5aromKWYhZuoOR6kl1rLbD9Y5oHJtc7j/0xIpawnD3mlAxK6sAbtDVde22Fp52Oa07II6r4GyW3vGbn2srIUnXThoTPmwJTm6VSl8N1/cbbUQ7YlLt1a05ojTOB/UUljmhbosqCZyWE5FYJt0V2HSq7Hy5oqi3ca1VVgCzZZ2tlmrENiVX573g116Cb42V5NNnBaVuObM4zvKifuG2De0f4/8+05/0PfszaFC1rNppSjs53wDdHyXlPnO9jAE62zVUdmqB7VVYL50z+g0pC2Dk79iZSfXa0aE2nKzpBkxxX3g8SL8+09P/P6nz7y/GJ9PM5clgqebKfP1w4FfPUx8/TByfxwY1Rm8sizn9uxpVKWgUiQHdWsBqO10W5u5iNDBmrxqDUpH8cslKGOSmNOBz0vmX3585J++/8SnJdbrzaT8/GHgFw+JN1PlVhxK6D1ijazkXuqa2Dii1s7lhn5KSFRh77rSk1BZLU77JOvVh0RuTqcbHa16JM/FOr9ZGwdeVje1QqZKCB+fXfjhtPCnx8L3z5W3z5X3z8ZcYk0ds/D6VvnlfebV5NxPmUOCRA0qlRu1xDmqgzIOiWlsbnGtmr0aIVsAD+49wQ/UK0wtApAL8XBpFdCR8yLMJXMuwsfTwudL5bkYT4vxPAvPM+EsZ0L1FIBSUsyVSwka0VJKaOt8s8wRATlOBx8Vskcg15WlA85xgPsMrybj5w+Zf/j5PX/31cBtmqF+Dk5WaodJy05TVvKgyNBsZAVgAE8ss3G6JH58b/zph898fDyjOYQ645DJSRCrm/rdFXSgmPPp+cLzPJPUmcbEISeGQZhSfD0pjAMMqQs94r9028Stftsmnm68nC6k8oqSmnVecxGxGodiO2RbBL9m67UWSmmWiBLWcJEA5NhsrVKWuWX2m5mu7MqFuY27KGR1hiEEMSphEShtp+mlQvMQHo5DaoGVrkGIWRyGIdyp6Eot0HaodP/1xp9WXQOUPkvTVQDVAuzuQ+3No9ojWen8xJjkm+PAaqezonWxqUgT3CTZbIU6nWRFLcRXEait6nxt/ubdUslXW0uvRnEPvlUL1L3RVa69W30VQ5W2CFPznk5rAqA7ykPdcTZ3yYm26k0LAnpZVTWv14R4O6Q7nxRcS7MyGsGay4DOmJzbXMpczgfe/1T47ruP1Aq//vXXvHltDHkJSkfOaGpcWMmoHlA9YDbw+XHm/fvPJBl48eaO411oBkRhyN2Gy9qzqO3QsLUMHZt2bW4UzrKURjGJqZo1bw40TdAbgsGw8JJWcVoRPtEv/F33Pr6s1aSUd97WDSne+8TK6iwT9pWb6ZR94SNsK/K8BSW+BU3tAFpROQfxQFzBWwLqa+CSEExaedF8fc/VcsuvXbrCwrBZrV4xuBta3dbHpgdogVxLWmrj0/Y1Zju7PWk+9bSSvfvOa9yb1V8/ODvXttmp4iGG2jym9+hh13Z8+Qw2hLSnCN5dJETWQCpoRWVzYHJrZfXSvKzbwZy2RKUnOb6zeNts9+Kzg7Kiq8Dwy4SOnU91T0D6+6Rd74kewLm1NLd7pTfUvbtwuIVPdEfvc5IrH/SgPeVVkNiTiB5MRkJZEbvCXNdKhkpQXJSwtVzmS2gt3BmG6KeghNC2LOUqOe7Vi41e4u08sdU3vdvYaduTeoBkFs4n/dl0Pn1KiWk6rMJyX6kfrJUgs7pRotYqV4xH9EDodr2yUkf7M8s5uMyquz2g097W8zbK3yKRjEhP3FZrvdVMfUVq3Vjnq7m3CFJWr3N3uUrStqSVjhSBWtAjnEAuJXEpcDrNfH48c7mEOHsaR24OE3e3t4wZss4MmeiVoQI1ks8yhyOadC/zTr20bQ62MsdW0/JOXQtng9pEt7Z5GcactqApGpmTKY8mfPfhE28/fGJIypu7G765OzDOFw45B/reXEJY/XBYNVIqup61ok0MXtoaavScHrivlcGejnVqnfW4oFUifKvS1SbArPu9TmSdO133YiljkqlpClcycy7VOS3G57ny4VJ4+3Thp8eZz+cQqx8UDmNmSjBI5WYUXtxkXt4J0+CMOZLOsJU+IKmDXbbSZEspFCvtWTV7bQxtgtKcArmXJA0AjflcqnBZnOcFzjM8VeG0KM9VuRTh8TzzeIbz4szu4aji0QukmpNITZAfX89myJgHH5JxHOE2D9ykgaM7t1L59esDf/+LO759qdwfFyY9N65NKJ81gQ5C0txKuto4l7Z2WikmzItyuQhPTwufnp23T8bn54Xny0Jz+WEaMoehu6HY6mvpkljMqRaLxWppdBJnyjQvXJBo3cOgUWYch7ieYUxruapV0SLZ26F5ax1l3exaVtxrnw1NyM273NrGK+o7TmZzPmgcpCS9eYOHYBSNjbU4l2I8ny8spaKSmYYjSTOaJJrZUMELIsbxkJiyMmbhkAKxl4achFAlFg0djWwGXH2jDfR52Lxf22G99wDdm/8LsalYO7yl8+XC4X0Tr+0QD21lze7v3JvBrEPK5mG7AhVuKx2ie9t2YWl/95RSjHfjloZ5il1xc9eIQoUhjRu33Gw9NDr3sAc6eyQ65Xiv1JtMsfnsgv3Fwb8i/B0Jakgaba724LOXEozGt2xC4EptQXqK73XP53Lg9Ki8+7Hww/fvmCb45tsDL15lxjGvB2tseCkaIMmISMaaZkF0oCyVT5+eOF/OPDzccn9/G9URbOPN+tIC0Lod4i3Yi+StIQNCBPwprcFlD6b4oplH1rwmZ71U2RMP8+6FrGv5uCN6PWh0rhtx7H1e+ya+jw3MenDgV6jkJoz0LTBded00n+rmJWxRlu3JoeyCOlpVpmJXweg++FvtP3duPj0AUd9nbA3Z0zZv2iVYDWRMVsTbWqm3C52jqtM1G6vIrwEda/MP3znG7FDzfQOa1A5eNgp2iG37/KYJ46xuPR9UrhFlldWhYeMh+0qtWalu3R6g25WmTkvYjaPxRcOjOPDW5iu92ZHVjb6iPejfRH696rA1j4k9aNO9/JX2Fjvh/76OsDVRak3EGm8+9vYtQehJl5mvz6QHWdEUzXZC3rY/+0bxiWZty7qm2dEjNnCh7y8NjNj5Uu/9hrsis1MWdxbQgWjaFtDXUtfsLDW6ga6Ax+avLXvqh+sOafYVIe+WmVdtT7wBStbFlLajJFlzO+kNz7pfc88p/a82aBGV5kDEVfKmHQjQqNK6OHVpVqJ7ofKqVdmqJ7KCaHHv1TYdDPv5V2u4hbWkbTwMaE7RqC8PpBRnnJkHtdptc2jpa8bDB2TVfng4gLlvztXeKKjVduDDKuCrkT+khEliMfj8eObDp0fKUjhOmbvjgUw4gUQ/kGtr7dT3pF0DIdk1NBLv+oYeDvVKne/2+pDDr4m/efCrnQAga1SXivd9Nn7m/X7YkuAIdwVDqaSteRuxjmQYsDRwcrh44u3jmd8/Ot9/OLGcFh4GeHOT+NmrA1+9GDkOlZwLKUeWISnjkpvQeGli7qiSzd0O2p0xCdOUGQZFqWCFlFgpYsOQNkRcm/2oCZcFHmd4ujhPszPXzMWU5znx+Vz5cDrztFROVbjUELzjCavNBtTCFjaPw8CQKzlHeaqWSkVZmtNAyuBSKPWM2owOmVoPMYipILUNptMEDtGFq7pwmSunc+V8sfg7Bzldk3A7JG6HCcPD9mjMjAmyhjUPjZuqSUBzU3c7VjuKaqsgUZtljnpHABIpd/62rY6ZncKQGpoljbohaxDZNiBvXPEuNErNq1JsyyZ3avTOrQxfzYacWxN5qcAgSKmo0Lw+lWM6UKwp1bUh5zqw1JHLDPMcyLKLIxTEF+6Oxv3dxDiEbeFhsJUjL6k3Awp/dpq/ZxxYeSubL/NqnSNXZvf7VoUaVj4y7QSF11zWve2DNy5ZbQGd1wjArwRtrHvbrsx+3WWw0TBb3BpdGCWFH7N3Ck1rHkPa0Gpp5VPtXtbz3DKs7uGctue1Iq9xTeEaQXPK0CsE/ApBv0Lqdc3mN8WzrzaX3YZQk5DT0IRqdRXB0gTBCx5iscvIn/5Q+dd/eouVxK9+/oZf/92Ru4cTKS84IyJDCwJaqbjxMp1GgxDQNDMl5WWGZRasPlKWC27d05qgdnR0X4a1u+J24I07Xu6WMF0j2Ru9olrnETZHG2cVrH7RsLAFLYEsu9e1OQpfUilM1sSFHbLXFlugq9VxL1tDp70+4KqjnK82kbLaRVkDEjsVyq+7Njb7UxoVTNjThnZ82R7smK/JVq8u+NqNtSf9tqLXfRi1X7L4FTElpU61iuqLiiO5UYc8sz9d90lh///VNq4lotKTDWdF78PRh6bHSWsXRPeNT79y0a6CsS8af/hfeMBcdQXc9fHcOlR2JLoHo51q47a68WyRgER1dacJ6eVw6dQ82VUC3EFjI0m7eeBXnS03KHS7fN91e4SUmhH6uk/Fs3DvFANb7y3naGq06gZcd913t0qEF0caNXPQQxtvvuwgs+FBGFTa+aObm0pLYHuzk5Vj3ffTBgB4E+Kb1xD6m6wV3H1VsoGAV3ZqdE7+nmJoFW0gWPK0G4OtsgmhaenrrNPSIgTddESsFJa2D8ieE7sBK53C0h2KumZBmlejw66b6jY3uo1ed5zaOtb2YW5pZAtKc6tGydofozmUaLMQxdFSoVSqLlhPlNgMCGiJ17adtTHWXYOYbjvpEYf0BEnEycnXpEU8raREE0PVUKlMAje3wqs0sSy5Nbetq8ieIluTn12H1lj/rTKkuu1ruuuY2isquwS+n937sfN2psceGYHqlIPLU3uVELlK1mpP1joC3jobh3N6LDXHgrIsBWv6naNUpofEdBRu04V3P4HNYEvUxCVPDEeYhkrO1uGuiHXEKIszl2gIV0tcR2hlErUZIOQpcRhG8AsqxiSZQYKJARVpjjVOpZpzTIm7MTHfJM4zPJ8XnmbnSTJ3Ce6y8FQyj0V4WoSnBc4XZ7ZuYBL8+CwYWgcmueE2Oy9vnK/ulPsx8/p+pKry3YfKxw9hWXcYK9MYjVuG5Kj27pDeRBqtRCwOpZAIKsiYhNtDiHrGY27Cp0iNcmuPrr0ca2HxEgeHtc3XIBkydeStiafapoCkxhvbd3+y1ToxvEO3UgPd+qeJ43rwnRq3Nye9EvlFK+zmMdk62LEdWU3FGUr1slyY5yUEPcMQqKOXRq0Zmq1UgrZhL5cSHrdakDRAGqiemZcIDue5UIszDsbx6Iy5cTtzZGU5Z8Ilq23sQ+ML7niLK9o1hZBDfDtsZMfn897BbaVL6Gal5psTxrax2i4gqhvaVjaEWPPmIbtKPdzWUvTKg+wOJI3nX92CkCqreDjGrnUR1JTCBi+14KFYiM1UKa2RTr0U9gTCDb1qDZvy0MZKyTnMoLQHVb2kufLstxNKUqOY7DqBxcujZEejxdgakTWbJvHW4EURT5yfMn/4twv/6388cnoa+NnPb3j59QP5uJCGO5JGECC7zmgiQQMKFLAjKs0tSJyUBo6HvHLLaxNkLaUylxmRaBAyDCnKa97neb1q4e1fdFHzXRve1ULOYy2W7mTQ0b8v2ia7b7zq3mRPrkrr8kVr581irSd+pW7VnCzgrRrTtQVJAz1dfe7dVtFd5zko0ugDm71lp+JsXfGsURWVrOFU0Mv2tmtTr9J/Y5ccSL9mvZKObd3rrKGd++B2S0ID/G+ld/VWCs47JNVXV5U+H7oPgewO/R7MIr518ttVgbYIrx3xLeAWETT3eW9b0PxFg7o1cPyCY70KvmULu1fOum/t0D0RyfLqhhN7iraDuQeRG3Np9d3Y8eKvnSxk1305xttWlE7WDoa+jmUXOfY1Ll5bQrBPGOVKWLsGv2wWgj059b2zT58f69aTSOxocD2A9y9TF1YkMLW1LTs6jrYqlAhYbRzeFK5ELpv75eZE5WHx2JrppF5RXrUPuiLWzmbjKR0hXisQuwCygw6dRuE7K8j2s9pccGypaxt1D9VqE0jHuK+2lN21xGMdb+3et2RayY3m1oTjvnMzEV3PlUjMO1ikO8GmrEgvfQ+LcujW0GefC1l3doGsrUFSbdaLPV1ug1J3ItPV51lS7CVWdxva1syo7sXHX3RydG2VlB4klwjctFWI8814RT/qvtImvkuKuHKu2hnnctWMEt1Qr6Yb6YmYi23UGdm1ol99yiNyTs1KVy1h6lSJjr3W9PEqimtzulmBo5Y4N6G5oQGEWfjFu7R4zYRsiRFnityW4yFo0cdcOSbnkBxN4V43m3C6wOPFefdh4fE5KF6icHNI3N8fmbIG1T7VdZwyQtbEmDVYGFkxE8oS2iBrVN2sAaJOIkF9OeTwJi+Zz+fC49l5usDjAs9FeVyE91r51Hx1bGnAwf3x4Dfi/Pwm8ds3I//33z3wjz8fuJ8KpTzzfBEe68iP7yt//vETl9PClDIv747cHiGn4IqXWkLEIyGGnKZMFm92YiGciY3AEbEIRHNahYLhhBH83ep143d6XcuYYV8l64QMm8Lu4VvX8qvIFiyuNoYN5ZKGDg+DklNuTiJcIXyKrrzlldPUs7dqqx/5VSlJm7UbYRtkFvQCFQkbqUaD6Athc8uITpW1lVdFN7R2Dfy8odjd9qd5eM/L0rpksYojzaKN92EaOBwmck5dgRaHlQquQm7jt6K/pazUDnGu+JXR8KCVpFvDEN/ZGmpvAoG04C/GVnNq1YYYr46Ci8jmXtGDhdVebfPH7KK0bklJ8xMW2cHnqitS17NrEXa88/Be7WXLPrYrmtT9q3XP9d4Sig0FaJuaCC6JPB3WjoqBtqaGSLXkYKVHhP1XHPotaczGsijz5Y5/+l8f+Z///XvuH+74u7//htsb4en5PT+9/ZGH2zt++9tfcnhRUL20UnRzGZD8Fwhs5xr2oGghXHqS5rA3rHCZF86nUy9whO1aasH4uCXF2zhu81xk52m9lvl7i+28+j5vLarj/zsnvocXBq1Lqu4oSZtVnzVXneCbb0r8be74msyVWtd+AZ3Lupc47ppgr8F7R4Jk/aGtwVsPvrcQ03DZI5472onrmoBpEy6tIZQp1cKTGd01uja/SgDNtnG1WrG6RAUmpYZeX4ssO11HV9eT5qTTjKWvxIqdQieBUvZyq7T+B7ojkPmOD73n5u8rHR1d9e5c7BsktovvrwR4O9+KHRefL5pXtzL/TuSlu3G1fW8B/rKism9L3ZHVrQudXyWPe/5vp6k4glrvDLinU220KtkJ+2S17Ft/fFVpoWlUzLaEYQ1+eiC596rf06vWngLbtXfryz3g0as9vc01OweLq2tZkwvdQJLu9LNWo0LwnNO4NvLplae1M7Gm7sK/7mva+dm7Pg4hJGetPPSGObV0yo2vzahKbypUa3DVq60OS1Z2Tjmto6OI7tDcrSphtll0Xul41zN319TKPQTzyF8wkWz3Ht3pJj57c43qjl9dJ1XX7qo704H2t3Ykve51Gn61tnRXiWDXkn5Zdvev+kWFaTvL1vmkupv3+3XWKHVtPVXbkqFtL9crai5fzkeza8pl3wvMr+icTq+iBOe5z9lVzNuuyJpzircgOx5jCsYE4fAymzPXylKdx7nyx48Lf/44Mw7Oi4fEt2+OPNwkbjMM0nntA8UyZxfeP5344eOJ794XLrMzDMKLh4mffXXPyxdHRqmMWpG6oLagXiP4zsqglSQe7i2r9KMJgTcpKt5Ap1Is7IVTZq5OscRpcT4+VT6cnI9n57kOfC7Cp7Pz8VR5mg15c3/jrwbnd68H/uvv7vndbyZeTwtaL9S5clksIPWT8/kJHj8XymzcHiYebjM5R8ej0KcYWaS1eK9BC2luF9r4WbEGWtvulNe9QT0EL97QKs3C0CgfScM5OKo02hq+2MbV7GiQbVxVcIYxN+71psgNL+Lm/dhKML4TA3axX611PayGXaLQPZ/xGtzulJoPaUPbSl0DxC7uWy4LosphGklpuApsnK00l5q94opyaO8GmK7Ea32x9s0i/HsL8zxzmWcEGPLAOHah1lZqprk52N8SMfmu7e3ama2LV1r5MDV3maFxeLvdXmqOB+2QWbys7VQ7Wt7HZRiGdWGrhm7Ad2VF1nbJDX1TxUqrgqjGM0nD6nKBNBuy5nYTLZq3BhodObYaNl1uttahq29oPrtgjfZ7axWku4LkHK7+3WcZXVGwq4TFrhvIuIStlEoCRuo88f7dIx8/fuD+RebhxcA0TZyenR/+9Myf//SMu/Hb393z6s0YYuYkGEvYp4lvnF3jqmGLiyFSWsOBaMZjValVuJwLT0+POJWbm4nDcSAPLUGWOGi7c8XqKb/nY/aKRreidIvmPPjK3V/50PgWoO0MkFdeabP66iXOpbTW6qk3qfEdtzROhrxDB/v7qegaXJnbFwfrJuD9UvzVqWSy78IqvraKt1L/4tCxnSh8Q9S25GzdDzY7jr9E1a6JqCtS1+kPtQVH2oLwbiPqf4Mbe23veO340MV3+6DcW2vmvc5ltT5pDkZXMW5HyDf2z1XDor03e+MC7NKfVua/EtGuxOWg1q0mzXKFsK33/Fdu1d1XkZju3WW+4CK7XdtH/tU/O8tMbAv4VzCAawcN6U41K+AjaxWxZ5i+D4R9o7/0JKzPFVlpIK0fQrUVel0tAtkX8HwNPPdJRzyYuiYEXQzaecT9M7rguV/X6kVuvVuhrpqazjvv1BFpPPW9zaqwBy7Cls/Mm/FBXtcDPUhujmZKWqsWqaOhTQxcl7Imy96deMpGd9gcgWJPX20Ur1xRrufF9jt69TT3QbpdzRHZ8ccjjvkywO80qb5eN/BBIWVSb7blXFE3l2UOO0rZ6Y12NK7t/TaR9FWrgCuNAGsn4Hif7i1fKKWuAlWRawvHVdhusq5pb/e56mz6ftGqf2uDP+uA3G5d7SqmtX/PWEEpGsmkhJArtGvW3HYqzA6zJ84eXUZ/fDzz7nnm+RJC1EGV1w+ZV3cDD5NwzNGVN1xllEJmRnkq8OF05u3TzE/Pzlyc20Piq1dHbg+Z5BcyxnESjoeBsRl9dIremJzjGG4pw5CDxbE6klkIbQ3KUpnb32KV4oTZiKbWHTfxeDbef77w02Pl0//H2Js1SZIlV3pH9ZqZx5KZlVW9VTea3QCGHIhASCGJIUVmfgBf+P+fyJcRLpgeTBPo6qrMiHCzq8oHXa5ec48eFKQE1blEeLibXdPlnO9cG3467N9/+XKAvv/8Uf/qmfEPv33E3/4W+P7nhOelQV8VLz8BP/70gp++fsGXtyt6Z7RlxcPjBY8PDU+rYmuCzREtDHUmt2D16SKIndDRAWbT4eUPqllEG/tXPNhE8wIISRL5OiqwSREBPh3mkJwkWIFmiZGVtjBuQpfJ+KTZvm6fzFNDTznrnGeU0yiAJo1hnJZFM2cTWDYtc+GnBvO6HhDJZi4asnj9kVA1HrLF3Y9xiMcU0JzpRyKi4gAIlz4Ac9x7EmJrhl6cZCS+gmytGX5vW/1G93RBn5z3fvh7uvgQheYtwT1TTTmA6gmzLotvKVYoKfbr1SglsIbo8nDBsrie7FEYWgAAIABJREFU3VnJbWmpF4+pYvDbMU1jDxz7XpoOP64bJbOb2+CST8U5cyYf2mQoJhAD5TY+C0oKiNAOQQd0BXSBavNo3R2KN4jsaG1F31fI8YB//H/+jD/8p/+C735+we/++ld4eLygNaNLMIde8khOtHHoGRBOdCUZxR8qxhX/wx/+iP/8h3/Cw+MF3//ql/j2u09oi1qUPJu+MAzGY9pYyTV31uQKx2/OBW4KLUhupyZe8Maqvz4IZ1TY7T9cGsX6dc/37dQIac6HT/8MGsH4s8f4mdU9JSXkoz5kxxS8FFZ+n9wriLVQKs5nzU2Tc5o+5RATdPMabu4tolnzeXqfonCdCnR12k2kMRYyBjA4zHrajLm0thBtymuhqU7MrxkGyjAu3govKsqUbqaK8b1Zh2cltmVw/8b551UPXopCBe7P6L37AmaWVKVpOwqwPAe66/iNaTPMh0NXPBE2yuRbi5FQJ4PvuK7rfaZFD5Ex86cGZGDhTvfnyVB/RvDV9cGZ236etsYmwZkYhShSeqpILx5xVEFuzYI9NggS8kalCTOs4UkgT0gOqs7hLPMuuYHWmKrmdHW81kyQDc6yjE3d2DrUO45OjXD8UM1lUF4wToZ8N1nKLPMIwzm11YZUzuE3NOfu03PO9zgNu5if23VTXK/5ZG9PCbLj+VnPqulsOTXlAx+JGzzo+dyiU+OhYgnLSdY5Nbbn5j/PvEqPitRxbei0YseGH6+K//znV/zhh1f804+CFzGwx6cN+HgBHi8rLo1xYRv3hIn4KoSf3jr+fO24qkAM7A3SjsbAZSE8XRo+Pq348LThYVUs1O1ftin3w7bg4bJhu2zYthXbtlrbIZ7AqwLpwNt+4OvXV7y8XrEfVkddD1j6K5tsNrxhbdmA5YKXA/jnn674/74c+HI0/HQl0PffPuvvPy/4D//tZ/z2FwrWH3H89BWvf74C+4ptA775zPjwccHDZcW6bFgAHFejdahShlc0D97kyVI/kg+7KPbj8IhQ03vFwGVxfXXo9TIalofuj9Id7h26O1FRur9xEAs0pjgxoY4VdmgBEQxYwbou2LYV+24TZBRs3rLMBaR9vbGGul4tlKQR4XKxqWvvHbsXd80Z5HEgB0uXYFIS5jEViin2XFggC8c5vlim8IMzU7pO6sSlGUzDkJMhRgUvFDd23MxBTWmNRqpTrsxKCplPS0PiIa65tdCINYNpqAgYpcuJFGE4r7aajj2mSFHXGuLKmOg9Dqb8ORZI+Zr31nnnol99IpDaTL9WQOQ3NSZ2cxhZbOVaON4aW4jzVKIWC5b+FUbNNOhonWIRpAPQhusV+PLjG47jwPPHhu1i0/40AdJpbe9Gr0ieDFSncfQtROLr1ze8fH0DN8bHjx/w+HhxPF4HYKhNoaGXDFlONLnngnMuILkUTeVhT4BQv5lchlyMVO4PIu9MKePB0/5CYX6m0kzUBMidFW/PZMnxh0dxHP4QTdynS5FET1Oy2++pZeR9M40GcrPGiR7VEn5SK5rs6yYtPBWCgLiURmS+n0IzHCZISRLHKNjmhlHGxFmQBvTQkBOdW6+hfU32dX4GSCkZ+xYrptLkZ701yAUBeBqOoDWnOMwSnTDlUX9n+n+6XiUGPmWDeGsep6JhHg9Qk8zNeMcqIamq+LHx0pPpFDmJZWbf7uksr1Oai2s9rUzIXlNsh9hDy6bJc6VYFWHaOXMAHuwyF9llU3hjpj2/vzSPYeP1KQ2SSH4/QunQnBDSM8HRDLYYTV+ZyFMU7d7c94i4p0I0iY30IZke2fchEyDYc+HYu2N6mw1MqlHeiSdMQx4Jnaf68b5UucfhAzupja6/j4faQHJhM43ma1QBCSW2WPV2YzUkG0NKWafqy9Im9vq453hskOX2vLvZiGlIDEuNdCq8KzRhkG7MT+cQ03fqDjk9b70Z52WcK6K+eY6m3qgiAkIXwtE79g68yorXjkGhuR7uBzBvzEKURvXm25RrB/58HPj6tuPtzZJ5L6vi4XHBw4Ut0XdRPGwbHh+svn183LBuizfmLrN1L5QSQcTSNHsHfvr6hp++vOHl9Q1f3gR/flV8ed3Rd+CyEp4eLEtFQbh2RacVr53wdVf88FVA33540M+r4rcfGb/97oLvnhnfPQK/eF7w/bcf8PQgYHoF5GqBK29m/lt4AS2apiBD0RRqkWYM0ngY5oOwu/Z2MekJwwMxdmctAs05oXahD1B6ygdUMjQg1rQR69yW5t3y4Xzo4Mza+qQ7o1SZkvzAXDtfsVWMjtVgCw14uq9HrK0klq2ByQro6/UNx9Gdy9yQ28gE8npH30M7Z6vgMKxSSeE7PLGOXf5AkUrWPDgj9Nc+MWGaNc2BA7T/q120S33EtdRBuzm6Sz1GBDLTKLZFBu6vtSUPgqU1K56zc+8TEiw5w1Er6gjXcOiaHSisnnY4thYR9AMdxIMMOmmMRq3Ee2tOzJAPEkn5y2Tw84Q0Ku50zejxngfGzcQtkGflUI6Hy9h4nOQGFLQP9xv4ylwU0E6eFGf/++31iv04cFk3bFvzItFXeGdAgqeJws2V7Fp4ZXswX687vn59xX498PT0jKfHR+fqKqTvYLaYdiJAqLlnQVNbHezqulq+mcCGPIioxFAXfUHR8kcTR9lIoOgyZx3Ajaa2pFFqOcDHA6DKVKgEA2EKcKmFbcVn0cDtlMZ3BEWlNrskfqJyp+P6aKcHXnlA8yQjGfHZ8ZCdyC85ZbqlDElJ0cypH2aCjJ2XOk2GIxGQMx1QJoY9oRIPUKbocmIE6hQkRDzMiRnuE4Wqm+hoWp1rXtPqnoCp6QDcP0Gp6b1BO+oQtlAhM4XWOgrhKhUarL4xrEGYFTFoJmMiqBmKMliWg7ChhWwSMrRZi34ixSQSjvKZoDAPQlKFgk4T13hQb4s9N6XPyXcnMzmK0TTYN9JatPTF+QulIYcJqVGc04YFpFmdr6Og19oElu0eLSFXmafLlHz+wLPGZ+EUlxLyZIZGGs8NUE7cjVsukOvuDQ4nyagfhw1lDnG85uKGSYJ24LobNOK42nM1iR1aAIs6Pu/QgVP1FNwpZkPyplO7g+FVEyqbZyqBbRFqNX49DLmRoRDPIJp6MUcAFgP2ufhFSI7yKNEb8g85ycvuV767kR4TdJQMDy/Kezlrqt9CT/dpde3DGQo0KGHdtxZdw/sVw66WQwUcu5Ht2KS0WlIjK/ZVxk2JrsCucKyhoPu/YtG5/vuC6y64Xi21dVkbHhbGZWugdcXBi5tG/fM6DvMlHvZ3vl47drHwv3VxzHJbcBzmydvdR7fvB7oS2rICyyN+/GkHfffxSS+N8dQUH5rg86b49TPhN59W/De/2PD9dxs+PjO2VSFyRb+++cOgGGAyQlOLIaplShamD0IAcUQYWVCIfbICYsGyKraHBdtqxYMFxthNwqlPM3dZMmZhB0kEO4AU67LgcnnIpEdeWk7UYyq958NEi+TCw2L0luE7dXYSJsk+S19IB9c09HzcrEkpEct1Ra1dB9IPWugkmtP1mKDXyXKEX0Q3bvIVvmGi1jVUsJoDUyXx8EpdoWaoSZhO4uCOSTmgaIubF5eqDfYVoGtAo8qmSEOUYgpqgzt69O4JXGR6/IVvpB5R1Kf5TwFtNElVtIye83NiOpnHxjRuFEWSpqL6Occat6emcsSKM7f5cCkP4uG8nx9uQXxo3NwsTCfTLjIJzfSOHY2bs/PHGpdumoExqetBFiCCNs40wH4cUDF+/bqYTyFMpKbE8+uCmkU2663eVquRL/0bMzpuKh6jQM9qXafER/LGYUxLZbbQUdWzInXblCvlGjDjUx9IiTihLDDsEj/KmpUKlpAmk2lNaM1HKmHWQE+TQeNUJz1aZ0kcpqmo3Jil6lT/7pSKfFUOvSsnmFB6p+93kzRZru+ForibPQ/2dXuZQNKsFz3pzquWdUzT1TYpMf2iVn4unU66CNnCST6Dwuo+r8+HdGYmF997b97bjoz1uxezEuSDKsOpelu+0yQiEyJRJAk0pSvSia5MpcCrxQ0X3ez8eWmyyYOu40wh0elrRGrseWJep+KzWRppdqUaIhbBPqDZtFoY61VHnhsFNkNdLebDE5FNiVJpEv3rSbyWmt9QA4A40XgjlsPxgFEoJ0u8+bS8oEDje7quvR8db29v2K9H1iutNagA+/WK69XM0trVTYoyQuJo0KemZ81ZCuaF+4L2zsRZZgjBKXPjnpwDJ0IKEU2G0Nwsn06DyFC4FxoXIICzXKXe83VgFQO4JG29s6GcDJvRIks0p/OzT+ksw1L0bvJQC2SiHDAlfSgyVZgzfyCzW8KDozbYFbi3bFvAqxXwtDQoM/aueHm94vXNNPLdOeQHgFcRvOwdL0fHy5tgP+wa2NYNj48rnh5tYn65NDS/p1+uwJevB3748oKXlxdABGsjPFwWPD0+AfyAP/3whqX38HwvOOQNSh1NCc8PGz5/avjmY8O2HBb6IkceQOZGtrQukZ5u2uAkIzoF9CFr6B2HKq5iq7PjugPC+WEwOrYHxrYJHi4NbemnRAancvSehxezdSvLws5PbMME1bs5az3KN3592zZs24ZdunWk/Zh1TYlLmzWYWaQWnXCLAicKTp9+NFoSmXT0PhXTE9nBXeNrW1KKUTWMCuCy2O8tbTy0Tat4+GtoqcvMokktfUtUTzd6TKPDPMgeGMAlKa1NWu0Y+qVUhr1IjgKODGF3RPODccDr4D56GJCvCqXjkDFxiYIQROhqBx4zY3NtOU/ObvtZD4wpHs46NbbPLwroWOcGy6Iq/Zaw8DHdFCjVjBcaUwVDpZdpY33QekIioSDo8tT13+vG3C1F0TSQ9UADQ751iF6HsiRNfIN2wUXi0tbAH0YMfDdmv7zZBJAYR+dc1w5+diVYjGK+avBHOAalSSd+ZrvOuk+4eeiTicd7WoJHAh6mjrYKTGJOUTHrNystgO5oDGooUuVNE1f9bC/SBW+gS2E9HkhDViaocgsqSDXn0OdkT8ZWB8ZUTpoFxv8PQ7WUh5PWnzOY30rTVl8qNfssl7BVoK2zcda+i8uQkLHz1pwBRzF+aky7T4VpbVJB9E7hPUtYMAUlnoYXN4yS8rVqVHrZJFB9H4FMjawGxjCIZlFHt9KTSiup4TZpraOaEMlZdITZ7ByqlM0Ne0ZEDRBKCHR9fVZMsoezzHr/0bRn00qDVhGTPt+BjKbf8SIpFVObwpIM75Ewm+wt8YzDXRryFykkmSzoqVJmTl6HkErxSCfOe6stjoRdnC7iUjvWPBO5TuCdahPXvQZymIKSU5GaJh0yk24YrWMetwwJXLz/3eWAGp/7ggbCSowH/Zhbc/LXeRwH2tuKZT98I80JX7i+7vm8iQRIk8xUcsy4phqRUaCkbMuk4DtjI+0hVHoOvqPKKxn3vlFYxvQ4fWu+MZkNoEFwa1m7zRumkHoMXnzSBHno8c+TcJMNtUkOk9dbaeJT/17C87RbY64pheWyGSuSZVVwUA5JCuZUsj5pbD7DIQ3snihLng+lXssZex6HbU4Ix0A/EuGZCM8XAj0sUF6gaOBm5/+LCF4Owr98VfzjP3/Fn75c8ePLFQ/Xjo/7gk8fdqy84sPFVACPrWGTA/rS0XwT/XghPGzAwjt4IWyfGujz80UfAXy7EX71TPg3v7zgb3/W8Le/ecCvv13wsFna4rUfOK4KuQLHVdGvJgMQiXVKM8lH0ZDZql9Ty51aXxCObolUx+EXisCjlBnLYvqdha2AYCYLqXDj1rIurneLkAMrIokwTdCIPDWtmIHqxZITB56RP6qahWSYQUMGkheTd1yxIjqOHUeXlEs0HnHs6qSAZVmK7hmTkTEn1C4voaJBjpuAc+0VsptZhxjGj2gERrEywhmCSsJesK/rhmV1/ZhrL3MKEhMhioOEswCJ1EnxqPZjv+bUNybwVNacmRIXOD5wbkpMrtKyq0Uk8ZVglzAohQG1l4fBObWSQBOiTTCQTXlYl83N0HjOMcpMJdZYMU14pP76afUHnPWhwzRMzqWX6fAr0zituw8kuSebjLLGL/SzXCEuznE2qZJkwSSiBZNWVu7eNIeMKx1ydcLit+6yLv69eDYFa51UV7zcidd9rxgKKU0Eg9QtDbRoQKsUYvYczEQTvQ2CycAOzCtK153OenQqBjZLd2HClPRYH7J14jtNZAvxhE5GrpC4aQmZCclYD4awnKbAZcKY8oooGmMNW6QiWcz6/dCY/ecfwT8C5EMwfSVpZucpDGvE2p8K5Dr9r81kMdNHxEoWF6TJGo6CMPX1pyRRPk1+b0bOU8gJsshD0cWPs6BMcUuBOxq+s2EeUzOqStPXzb9Hw5uSassieQJoMvTZWd8nDW9tVEyCwsUgXq6F/LN5NFjCY2z3Qk4TNTY1UPsAao8miZQr9NhBcgA4rLGEuOxTcrMXRulh+pcpOVZKOFskEyPZ7HYW2fSciz4+zubYehY0p7JvXd3En0PBEf4T5kwZOxOf2lYlOs+Ujorx8EIzZJ5x7nepITljgxFSxjCH9mt3tKGg7zv2tyuub1ffKhoZqXcbEMaF09A8dMgThAsVpS2tbDs0Q8hA7IFxIxCuFqXELZ8HowH06a/qDHy4q/PGjRyqi0yhV1yGf3dNuzp/rlU/fkNRUxqFvOhITX3HX9CLBK2CH6hkj8wSPJ2GHFMqAFGRkA25XoYuRRBbq88Sx0MywEuzTU5j7Mp46Yov146vu+DtAF73A2/7DgiwEWG9LGiXhrej44cf3vD6VbES4/OnB3x8Yly2bsQyZSz20AZ4Nb3W67HDiIcNwJLFysIMWszQgKOb7IAYSmtOufMQdnPTmOyaZjpcpGwib08X7LBnBI1UNxjFQcmoFtu62ofn3WNGOHswiFJl1JJzKzFxMokIx7F7XKzRPbIgdyJIrIRD2rEUqcOc1GgSh71ITupkPc2hzFhiReMFQ+89J9VTiM3JrHAmM0TzYhfkke7uupqKybQ6Km1ZrCEKs2NrbOuX1L976EbDmAAw8kGcJAOoMzit4B7bB990rEYlaUtxXIsW2QAXzdhgilaG7GiceGDOYhtRPp91WSBs66vz55vZZUzjgaFqulGuyWlaHsZS0v1QjD7ZA5wKK/uaLdi2nLEIScDJAoMLEi+MbsYnGxsiDEKEwsMF0tgn471knfR91aOQJyj11PASKr+eQcsoQjjoMFn0d+ekFsRc/L3CXI+pWST91YCYpZXpqs6GG6kGyDwcK51gJOvFynywaCmbGz6F0kAP6MRe0BQVz2dzTKVpWqFGCmuuPlN6QMOzoAph3BhGQ2ZwvofPtCItK+GKCkutMReDYYTBlEyavP9TIylZQEvvxlD3jcOyGNN9aFA7krzagU4jcl5VzRNQGhImSvOjMcp7Pvhzg3THWBUPxxuZHpcmYjJeSWlQFSJH0qvOD9Z6vt0QZuqvoYSeiU5kq/OE/mxum4krY/tRzZdZfCu8sCyFxwljaEUL3/IlYzlODPUE5dF8nzcalButedKO6e+YYrPSRwbqsHtInRxfDf/rn++2NGBh7Aeg/cgGS6ukiBQ2kLXk6CExiHu035FKeOMTz+VMVUR5fUVOoigFUCTVLnkuatXk++Sf2NIoR+MzN0uEPmR/mfZZcIMyJqeEMHMO79bS1rJx8M1cNxPjelnR+wF0oD1csD1vePJtqHhWxv52xdvbK/aIMQ8ssVrGCetoEyjCvcKEn+eA4JBxjaaMK2ZFHjwX5nrAhoWHCBp4olPVzWrACapZOAyvlgfghJCiABjntE5EmcRg6lnSxndJTL1bQ0+tgYSmYVqdqtvUvk+SOSvceZLrDenL8LGE/LYODq7HfnMuxSZv1CJ18+bPj2acenaTM0nHpgceAHx+YOCxGctcGw7ZIGC8HYSvu+CrHLiCoe0Rryr45y8Hfny74vufXfD5Y8PWDzRS0OfnB31cNzw3xue142frG3794cD/8Lc/w7/93Wd8eOho3EFkRRepooEh++EFhV3Qvc/8zThk2YNxjPntFAsZa8QoSl0ACnX9tWq4YN3cR5yxqMP57bB2HgWrPSAaWvNpKXgqFESOxE2NAJ7RDcZEN4gfZ31fvaiG9nUU3KFNrlqudV2tSPOL7Vzoh76rfk97nX3STy1pZuyuS9SJTMKNfbq+WugPzBXdFtOxH9ItOauYb7q/v8u6YLtccpUIVeO1xqS/aOYmdzUPCktSDEIGwbeTrIngArohZ2isEks0bU7Tl2ba/6UNYk1MPMUL4Qgu8fcl1qmIByxpFpjnid1fIqPc4O7uaHMzlKnoy6vRliumiUv8+IzHmCYOtXh8j+pRjW9zgaE3uuLbg3I+nCeKQ6wibxrD2wKmvkat2n69H4hSk/tA7/EqcDIg1qJ2nq1X3jYRbjBqWpqC+nCqxbRdO/65NQvYiGl6/Yzr5Ds2OjgjDitSj+hugR5BKZEIGBrm91CLc+HleDVgSttNcks1NStAcqunFpr9A601Y+bW7YOW6/b0AEvcmpvDzlKYEfuuSUWILWBNywWiUZabTRbu+G7OGtlbzJneLeDfw1LmA1/qfVdld4FZ4ywW4xyP7109Q6Ebn4uPIXmKwdHEk1ZM18m4jnTiKE9aXC2BPbVpUMrws9YWNKwmOylbgK7iDP0OQJxlLKZ29ftFSoKiiNyEr4xh07hHLJlYT6QTuIyKpiKcylScMmZ9mFDNUF/lEuGh4oKHLRP3actQdOOgskmkYdTTe+f+jFgMCV8ghyMhs0XNEeZvz/iQfmR6qZnzFAhowmHXmEluzfRpDYB5OqZsCOU8k8b7Mzwj9f6s98JCS4FRaDLSQ2raliVTvKtXquIAb58vt88PDUzgRAE6ne+gibSZxa4MIzGXZNLa7M6cfr2Z1t/Se850I+ep9+Pdc7ia8+ehAeU21i5GTiUAwBZoeNj9M1jYNmXvrOiN8aYLfjo2/OGPV/xf//gvkLaAFgKtwAFF1wX0zdOzbsx4oI4L7fh0UXzaOv7qZwv+/q9/ht98u+HzRXChA4vsuDQGtOPYd/QeMcpx446VMCHFOmjrajHgKbGI6ND6hvVEXaUjmMtDL1ZQEgW6FZYW+z4OVpOt+A2quOFequod3JjOOi7pN8VxFfBVM07qrdWKwpBzxKQZIfVIOY69RlBA8A/sb3thccsNnzZjXxl5gG+XC9b1MljbIbVZPDyoWZCQbypBALr2oX32taD6inld19wCCiylMTXG3VA+EaAi4iZQj8oOzGBowerquZIqpEgnlmW9wSqlm5pdmsMrGm9gXi1BktgeCv3A0d/Q+w7VA+Byzc1K/XklSbeFnWilF+jszC7jmSxyM86XZplCkAn8dQw3NgYthjxrVyMUShN/F3SMKtmaDFtagllOSM1KjxgaTb1BouV0V2cpzf3ql25+PbFSt4Pg5J6fWbWz+Q8nTTndQRbS1FDce203TdHUFHAehLdE71Mh44FHdCKyxDUR8oJzGl79DOrPM3GXaZnRixWfhxEbndeKYpJK1c/llvKBQkwQn9aX90tpajqAudGdZUWa6bLnifY8dRsykPA7RPMYZ6pM7y2mB9vctPEwWZZNBjl95V9jnKybTjmv4Aua9dTXlhDSU4wlFV2wPzukNAjvXatnMsRsQD1/nvXyaf+qJh94vzG9+dlKsTv97IrBqvazhdKPIYVU8ReadZ7PETl9TtNdpr1IdkqRjVFgBs0i06jDwI0S4JNNCY+mLAZeIS/JQnLQM0TnAj/pKyEnAQNo73gXtEgpdPaPUJv8BhQ+JpcS5vM75BMi0N5dTw7s+47r6yv2NzNzNmYs7ACFbsFC+7GjHwJWM8dHsUpRuAa1yze/KpoJwqJWF1XIAtPwCOR/kwElEjnZO8QHgjXMZ8QF+LPCrwHTaMfGRRLTaH9/ACIGcGC+bhnOcC/EJy3bThmda061e0V1nvwdWsyk1RMnXaDEN4OBRC+r3BFIAqBlCtWarnFecjtR8c+WUKPY/bM+0PCmC/50Bf7Tjx3/7w87/vj1wA8vtoFkBujDw4OyimFSyGTpGwMPrPi4Ap8fG375ccVvPl/wy08LPj8AFz7QIBBdcRwC9CseVuD5kfF0YWysaIsMPBU18LIC3pVBXqepX2jgqv4v5DBR3LZGOT2O38/fW9psMGIEOsJuAB2JjaFnHHzbGUMV0/BadA9TFaYCMiZubWlYlwXU6ATr94NtsTCV4+joJZpdpGPfD9fkOjuTI9hlrMbj9UbIEPuUu8opci3lEfLE1oSEmSHkKCHDsymgZIcauMRAMIUe28gcy7QmDp2jkU7azYMgErFinSmpJ0Pqvu8/VEt4EVwbRgxQywlE5KgPJNwwsBjyshVjSpRjRdsZD31yPrfn9qm72dWRY/ZQ72W6cSpuNWQmNE2p4BseLhH36tMglT6h2jKZk1vKYWgqmIYMIycIHA+COU6aMuo6iryB50rlsa9a6wpxmGm9seOTEW3ilXOJ+OYZN8inz/LU/9Qi5mxYm3W29817dzdPNHSJo5Er5KWU9hRyhidzZjOsVRNeNH8VFDHgKuXBNGuc5+S7YcBUHbkCIV5tHpk+GiqfwpSH3f2ftWwY6rXgrymnqxg/t1ZszJ0ieEgZSiBYTjXHhDY/P53lV3ryS5zQT+MeoTGppEDcQSa+Op23QBQCm1Ek50O6XENSNRiw8NngSed9MjWcVJCdQ7bS6E4SaXl/7klXzlSZc4Ee14Xo/JpvNlYnnf9kdtaTHKZsyKJgIR9OUJFkzEV4KZ4JRSJWNfsxsddJJnNPN3y+J+dp8TmJ9dQ0xfCh+DOUqBTr8Xn7+SmYJAKBaI3BTxTiU5GX+kmer66KFaweHRko0POGZDzPbz0HcVpKd2lpxK6nkbmD5Gr+uKOYGoVsctwtnCU45Jbi2dEkzm89fV9K9OIY+jii0b13XKU9ubWmQknxtt8xnKN47mXoQNOmZTRu3VfmAAAgAElEQVR2I/mVFWk6Vb1lh5/9E/HMjYGHyu3har46mXICfP6XTdzZc1Kv60BCx7CgOx7QdOQ0BhbqWw6ZGfdE49pRKQZuRKiSproCpNnQ2pbPtf6NIWTx88oLDmq4YsGfror/9Ocd//GPX/B//8sb6PnyoA2KJcwxpGnQ2RpjY8EDdXxcFT//sOKXn1Z8+7ThaQMecEXTKx4XxqdPKz5/uOD5gbBxx7YoVA5o72ZooIGzEcgUp2tFXFwcZWrH6izwBmoWqBOUDcWId+bGk2SkH9YFEoAux2Be0gjcqXpPRTVBaerWOQtM8oCXI/VRVCQyy7KO6XgYC8lSECViiAfywlCHxyjCg/TBjScJSXMZSXWHh844V6IuH5HQj3lHmUzXwtMO2oFG4mBJKNMuydqGDjkGDZeqmSRjGiTjPUq5Aur3Ghd6dTyfH9I3XONCJJjS4vwG5Wbg+hgnJ5Umgdx3JCLTKneWSIgX0VpWUOzXQyXHpBklzbxVkxw6Yz3JksbqLA/ks041Dydf/aklDFKz21oK7adOhYfeTVybfUboOeISNKMVBWW9h4IVi/d7rKdLaZefqeoorOoGSU8Sgcm1X6IwE9EokvHcWUvyeKCcp3CVHy4nI/E5Uhq4LQS1QqYn6kWbHsIZkFJ01uEoHcX3MHwp5pTBsrwupijJQjKKvrEJGr+njtyis/TmLKHR+lAYqncRN0+Cc+vFrvE8c8hvOOjgUuedEHe+3axowJspNBUIYZoaKUOsevL1x9cOlCHTaESGMS9nmXNSqUhKblBZ646bJRh5JJi/4YEQHUQTolkumHp3nZMqQ0aX70U0rFzPGi0pljRpg8ZE2qUYYXYjTE14rLhvrguM9Xx8vUH/QdmgIWlYg8NN888QE8/4ZUFuVPP+Lmv3GGTkPU00mZ9v/Aiqs8ykSAZGL0ZT2up0ThJPvoF5WsrD1nIO8KGhj48/m1shT/it6bxiER43Mq5J0oUhJwltnMpIPB3kV8r5eUz11be/FiglAHYwG0pXnUGeTazAMhUOhXT/V8zc3IQTPSwediWOtAwpSRIls2DmTNO0VzYMi10ExyE49sMpcaVAlzGdIJf65ICSxj1frz9ybKCKoQ84318zlbbWnHXek6Ue92qcNT2VCDR5K6ZmOhDFgkHQ672EKnojNmUJjA+zowYDxVSeXEFBdwOO7BloXgCRQZoSBboP7tgzRppvJuBwke4wCPXwn5WA5nr63jZ8wQV/eCH8n3/8Avr09Kym9zp86t1wYeCRBN88NPzyQ8Nvv3vE73/5gO+/afjZM/DxItjY3tSjC6QffnCaY90CXYbWzfjbOrZ75NPpDLBhSzVszVIv/YInNsMlcxukA58Ag0Z0aq4m+hX7PvTa8Y4NxB5lUVuxTmAr7LNIw+ggk9qRaZh9wrJVE8x5Qi5iBa1ksmQ0CwvWbU2NoBkV/XXla/AiPxGCwcIuvu7CKu46ghQ4vg7ZzdzFI7x9+hpmLbvw7T0fCY6Osivs0pG8FzfnbHAUGYmTNbQkJb+KfN/P6//EAJbwmHMaYG4oege3xZudkjoGNwTdjFpoOvQnY87kHTjLTIbJVUUzLbX+XVuE6XSj5zQzNNSliOE4sUkx8CAl1Q+BcUSuvEdDMsd654NYdSK7VO74KBrmiYcVaPA4es5o+txicIMWvvcUYOJbhZxqtkKWSXe8/+yl6G6uBY1D+54BrmqZ/zX/SNebwmjCfVEJT49ro+CuYuNATFMITp3+ouK+CjShOuWrzKAWJaRj+kfFD5DX3BCxnWQmZQp/R5pg6+YBy1QREC+TxjsbOwKgbdqy1ATFe0X0CI4aOuQgSqgjl7QmUY6/MN7n1ML793ddqW0zb0X+oQ0f5AOkBpzvFd9FyjOmrn00JsR3GzDcmVDHkIY9rwInwgyXqVo8sHP6VxuayWswNzexXc37keAa63nKX89ETYZ9pSCpN+eaAS75OdBoouPZle+lg3zhRIx69U0M/zo4LpuR9yb+CSLw5++ZOpUsccUMI3jHUHv+vXFpNS8iK43JJ6VxbuaGtG6fOH/PgufavIUpxuxbnwVN8iY9P1P8PeTyGaZMqY8zgdCheljxrZ5x4rId6QrtgsPD+lh88CEEluYSON+YkkuhZDR2Xcygn8MtZaweLKQpD4p8j+Jrcc16SPSkD5pRZbMryIaNPvWPZiC9WVpZ7ZRGeVXFum2OYx3Fv7g8Jm4eS/5epuA4LYMaKUhn7aMBEi/oh+m9lY0PCjkrIHpacMCD43+I5K+NDQ68gLb35TiADsauhFch/LR3o528HRBpuCwLLsuC1REMot0Q1sa3wQLFSornreHpYcPTxwuWxyf0ZQV9fHxSIuMeXmjBh7bim2XBd5vgN58Zv//Fgr/5fsWvf7bieduxaYceO3pXHIdGiKUXcKbZDlkBF3SbrTSsuFhWYNsW1/3GymZ2clvRTRl/LphNMxEBHfoi+1COSavIbFSVOCQObxJqWI1xNsefD81Qlz1B7mMaNFIk42cKznk8POpZH1MEo4rY116XBcu2Yd0253ZbgpK9hoIXggcRsZkL9351PqVptwPjmGggMtwiO/M3mQiqOW0SNQ0aM4/EvhIZn1Hz4HxIhwtcCxbOYqS7FzzjkLVnHmcRqzExL6a0jGk7szpKMTwla5eKN8goXNZPwTetBh7gFvGGkzyhztSnCYwm3TkfspCBRstigaRMrrWs0HzzVNbF0XTZL0kxklYpi85hFSmnmU2rOGlKp1XypFfHLC0BldXsxHSbKQw8p3hmsRYT1aq9JH/8kE9wSmJh/hxJghgpo+TFGmPWd2sF6Gmhl2AahBhRQTFTDIrxtiZcjvRRT/TDTEIhzIZRPfG161Q/JXKIiap7VW4wXPABQW3GNbdGwGxIqw/zeYJIN4l0UC6yvFY+P53pHn7+NFq9wNQy8ZuLp1nrfautJyx5nkkRFEyUD600j3rRnuRDJHdM7B6v7oOOkAAYur3fkajp9PorHcoahHaDSLtZUd/8jJlFkxPVSeuvd75erI+Ubrwts+nMz6JpwDDI7TEYCS59HIZyxkfSABTISa6nNRApUaRBY6ld60DJxn08muYRhhW+hNTd1o3U7dpykpPcmHN5FG631CC5McTGzytZfC/jvlHOpgAKCM2EmPxIJg9EeX54vLmCCx97hLegyPTiiqbARk3VoW1W2tREWEFNU3PTfXB2WDHuqZW53ZCQlRjezqgpYlnUSuNzLud2pjQrFzSkSTpI7FwN1re66iDlhIWsIzkgcQ14+RFF9MS0p5SKxf9u6hSlEtKV8wr2PG0asAMDcpi0JiASzL59ZKsRpDzb8kwTax5V6GS8Dla9ltct4xmnvuUociVTMLgc2TcuNHlrgEMJhyr64Y0UNXRiXJXwVYCvHfhyBa67NSisVnhvl26IbFoN/ymE3nccalkbhyoOtaAocAP9+psHfV5XPDDhwh0P2PFxJXz3sOBXHy/49bcbfv0zxi++UVzaK1h3cGcAq+uLNTXFNqiRMWFTQe+7S0vWTEMkHsaGampkpmm9C5en9KNj78esEUW/4UkGUaUaDuLvRPT5sjS0NTjcYwLZxcyPSmRSl3JjxtQzZCCqaulY+3UK9YiIdfbkx9YaePHvu62m7WW/QEtgjnp3KCKgNEzEnwsjn6b0wpLjuuuLa8KYTtSNROkVBjI5dD7xUnp2+xYJQSaWUqYvatUPxw3LVOKuR8w8Y8RiR/BB+htpAMIkioVIO6t6Npk1ZZNG15slTswdT1WaKmZpSDQIuW5HptrVSGpMHF/4VK1Oly0Dq0bpzoLHmnIpk8FMw2CXJtP5YT/qt5gUazEP6g0FpGKgxjTPg6LK9Hs0QGx6NbWCOQ9yDxixa0KSqzs3QZTGo8RURWrqQpNxcDQdXCRJhudUUW9GF0eI+uFdorLP2t5qcFydu3/W3A7QsqYqgCbjnUeH1xCf6uwvalXb4khyeOMaTg20jk3eNCkjHca+UlxXKkBjniYu9SEXuuMuoeEcsoJpIkiuNiQqU+eSgBoUoracgjXK1ymkg5HaNzCtQ1FRqDgu1Yn3V0v6o2C+JqtOVglTs5nEoOrBwElbjw5M9+eMpK0FnJmvXf7iPhS9M8s8e0zqf3LdGqBG1b/jMs55gSYppRZCgcabtoG4jdvO4vNG0kPT+j/OynvFb2qas8jkvPZnFGIZmLgEQAtH384zzkZpfKA6maaDWINTsMyZckRl+DJworPOnLyQZBq+nsnLUcOUwNN7108+gXQIaPFeUdX8082Yf0I+hnQTPGcilA1ZpVFV03B8fzYbdW6apfeS4GoTYDiwIItfF7fvR8e+X63g7CHnGTKQCIkzVnmVxAr06DYkUU8V1RGqJaKT7plcUmSb8bgWatPpA1TP44B/LZUI+Oso+JxMEpUu0zMoU87dHxevV4tsUp1+wqApKV19q2Is+yWKoQwTy82OjMFLbicdc6nCbsANqQ2budXlMiKl2SIUhHMN5hqyra7uqXO/XeTNmJftcIzz4hkzC6R3XI8DuwC7LmgP3+Dhm1/iigvo7375rH/3iw/4X373Cb/5xYatXXG8/An99Q0XXbES4elCeH5WLMuOtiiWZQPpCs2Et7IGkgPHfng4jhdHPEsxDrka9qY1rOuKdV1dgx0P7zGFrXztGhxjk2mdEH0B+48o9m3bssCdItBpTFyO4/DvZ8SP9XLBuq7Z8UoXHIcZJvY9Uhw9QAIeaa/A5XLB5XJBa/Z1Qi5ynuwyW1R6PBy52cWRhhtPG4ti/O24pgxmu6w5sbeIc5yg8zoVFpOZxwt4KpO3LMzr5CMMeGEccdoK54Od3eBxuGRlsUI7GaEt8VBp5tOBiEte9A2fdzzglpQTDVY3dOjpb5MO3SSWDyDMD7kp7ITGSpZGmtco7nTSnhtNQk66XnsfR+EmN0i4sw6YSmDG2IzoHRZxv4kEz6l4TnGrNGKe8p9hLeNhTEkYOJv4hqyEsmAcE02aDJdzNPTQW3XM2597JrT3mM2xvToXojfpiCHhUb5BH95Dgp4naVoX7pH2WK4rKUET8Z6Kf/6SMofx8KfUxpay3XVWolqSN30rGFWAr5CrryEpKKBSwNCEVbvRf0slUfBI9sumwjTfWXwXXfxsxKuFKE0JvphkzVaYVD3umGpiMiZlWFWVE9BowiaoX92E0ZyGSbjH6dY78oWjIBTpBjX5Hr5xTs48cC+m/h5mcxjIkLz88xkgQu9IGpDehzP28B7hZbqH3vl6ChS6Et1FsM0NsSMble/8rM2vD5kK6pniIpMk40xzOW9U7jHaa+PB76Dk/jLlCIPlCtyRsJ1JRCbNUNwavfP+WyKngm/O7yqNCsOg4MgU1nGO1bNMUvPLzI4kPCDHPvliVBXSdxyuF9cONO9Y2WUzKNup8FMloSRNkDExLzhSsadja63M88Oc7gE+Spm3YImYBd2Yx6R7i3y7KLsH7AVyM2QuvgFg9w5GWM4Iw6EbclNrzSUwPWu+kLKaH4PTgFsHGd315WY0b5MR2aRK6umukfRLN2ddXCviWSf9ZMrNAaEMz45weHiQkuHWGtAWaHvEizD++ac3/PMPr/jxVXDtwGtnfN0JL3vDGzbQv/vtJ/13v3/G//4//Qy//76htRf0/Se8/vgF/e0Bel0AWaC6A7RDac+IU/QwfAFLa1jWxdMhd8PulBvUpsY2/V7X4E1SphyZOcB4q/u+F0mBi+zFVjdRsBNr4u3e3t5wHAeIFI+Pj3h4eDATpgLbtuUNkzKRKDYh2LYVz8+PeHx8Mk2yQ9pFBNfrFV++fMHb9cWMCqTY1s2Kc6c7WAS6FfldxkNlPMhl0hwTSppcdKf+MGZmk++w4XF6N7048TBChD4c4InROx5eMx0gcWC+9m7sk/M+ExqCLR7mwqjswmXuM9vUL6dExR/61FrRgofZxh4ItaBhP4iUZEy8KAyH3sD5DYikh7ixUgXNDx2q08s0BaFEpZ8OzjqVAmYaTSm+CzkQRDIOmjyZkE3TWI/FA7Ue5FHAD7JBHqIYcehnjJzhG2mK8iWVobXWamSKYmiO+Oaycn5PX33Go8VDWamhBiVQRYURzw+ykSGfG433uPhSWLI4cxHusprfR7uRVMZ0n1jK9ygUKOa92Abc54dHMdDL4atls6A3WtDR1NP04JVTSFZOuIDSmNOku6J3kHJ1Yk2Ytxn2GYYEiHCW8+aEqBpjfQLIor4JoWwEKrpOUTdIyDWuTuSMmaahYVIKFFt4ZnRMyIdESmekmYyY6HqdnaUj90bQRDPFZWAaCys5J3uYkvDiv4VGsRnIw/HskHehf3QqNoeM6UwOohMR535o0Jn3PQWpVYlZPf9cA/zefV2TBKck1oLcy88Ly92mJRjtgWub/A433oG/TC06F+D8Dm4xmxKaUTR5ptNcYHMZIMzn1fBM3PsU8z0OuaXyKRjKsX06SxVjO6DHePbrlC5tugntBZ93HDiubzd41daGwZOEIRk4I9P1kiEyRFNuBoHtBhUkE1xBZbMBN5iXItYfs5reOE1jYxg7A8Dh3DDPUWlgJfRu0jvt3eQcbvBkbkl+EdFy/utM8nITdOQdzGF2hc9NheXuUpSYUvcOHEe3n390+9iPDlGbVkuXDBzLmqWu2bRAO3rHLkMeisBZVqNxcznP4KWZjHhhrA+PWLYL2rrh8viI7ekTrkL44VXwhx92/Md/+gn/xz/+C+h//PWz/s+/e8b/9t9/i7/5/hnr8gbuP+Hrn/+E69sb5GCoLgCtaGwTYfbJ596tO2k+gk8XrYRA31KylhVYV0FrHcKKdb2Aeck3MMxRItH5dE9jqk5pX1W47pq54JrI4kHbUgpSv2G2ZfMDCJnIiGZfdF1WLOuCZW1QRwEecnW0UaxXJIvlpVnRuS4Ltm0zmZZI6j+P/ZrTqCjYenGuV+G/sZ05C+uMfYbhctq2Yl02NJfqxDOH2R6kIQCZ0vMmWQKVYrSE0Wg3vWGYaTCMYvVAPRvABvKw5c2RHWLVGxeJBIPMDZzNjk7RB9bdXl2zpRM1xI/EMkoeTE6TKUghJyjmcAU9GRDP1IR5Kc08pOrZeav4luE+M9wsGV5UN56n2sApkMIKDVY+vcaRgEjv7bRBOGQferxKYig6Sj05p8wQQ3enZ/dwWjl9waAAUdJgCAsvlk6WBZ0x7NnlTiZvcCOOJ6gOHCHKVmd+vaNw1BKbXQyafg3nuhLA1ti18zbZCA1lTcbs0s0g7dKR1hiLN9Xnyd0cjywTEYmYZm2/PwijQa8SgtlPoKciqzCYSTOeeZ56kjf17pEBz6xmUogM43a8v0vgPofQ2QxDwfktEhIt+g6achZqgezTNddtViS2lkK+MklO376QPDgsimVifyboVWzjScBQzKUhRcQdXf5sWORJ/jLud52ClW4K4pO0JBr6ZPmeU/CIbhJw7+nv49fubWveCwt5b/p9Nv8Ctxz1QVn1c71sHXIQoglhLT9jaINLsizGhmbqFd+Z0luMutz1VuhkJtWcut5sqfQsBxvDrEFtGXHrWn6uaPYYPCVvD4oO3+jRmWqjVljxKXHxxqeE8wV2VZ1qUs9fHd2r1w4GS5Cj+yZ9hxx9bJ59A8fe/ARORUVw3Q0iERt1ZpoyTM6bVdIGOWTyBIzPnG5zHVTRD8MOtmygOWWkULIh4BEyo0EwWmhJYhRcHnwcxjCX3sv2oSgYPLQruOAxnGSaIQ6jIRl+rqgx++7PXmqmy5YIgwpkJOU1vu97DgSS0pqBTzywid6Q9EPRtePwKfgYoLEPmKgMIE3GGTK4ZbMacdkaGhtutsXfUIbQioMecKVnvNIT6HefHvX7Z+Df/mrB3//+5/jd95/wcbuC96/Q/QXH6xVHJ3RdIWg4ukktjmOHuJHwsi7YNgLhQN937NcDx+ER2suGh8uKthKULDbeQrVswnRZGE+PG7aFLLznuA7Un1+IxEBjxdIsiZEbY11NV+2CIC9iUSQo9r9ZBocxH6rrYIPbb3bsfuHsx5tJOhxpF3G3OUFoDY2MvnLs+9CxBfVFi/TUL3w4VYSZITywPKEjb+syiuG4GJcVbTGM4TCFuQHUtfFUeeVeNGpoQcskZAqxoFlGMXikSJMNR6FNND0gR8xvrHfdUOT8zpCHx0N0IfW10yA8xMQXkGSKx+edDn+PmybVMsEuulB3mddQn7EFmHXYOX3ArMueTDEk7zr67z1g7L/7TdR2GH7vyh7YVp5WzMgNYYImAsb80Oo0dK/Vz3Cetk1FtIhd+3T/56mvLTS/A184JhKB4iPiEkZERRbhWrngrDOVgoqzgOfUFJOnCUpGIsFXttLt2t+2DUtb/AxoJbExaEH0bvjKZOIqJrHYs0q47vVsbpynfDmxIy3rXZnSFe/JXMZrkgk8OEksiHziSO9OA+u0+5xKetbYNrktjOSGZTxQgFXiMh50uGPsmovfNM9NqbaURtYkcMALdB127AylIExG6IkY4puEFsmiKQsZWDV1B5aequUoPtSZ1+fJbZiiA0s7Fbuh9wwTGuYU3Hs875kvXBnqfGs4JH43nOd0ut6Xt5wauxr+ci5ycacBEp3leZh42JMJZ2Q8+Ht5DqSbBgqYTeYTZee8eSr0kzPl5J4s6C8l8957j+pZlp+pzp+VyR3K8GO6dzGRoeatcml4ak4DAOpapi0+4OqaAzlyZHIU2LGhsxRtRWNkMVsLUu192nyEbw1nSaKMHA0Rza3gbN4v2vXKsHaZowp7E4HEMqtgAB+IwUkuGfQUVi6ej5Cy+cBFanqsJiWOykYquOLhQgg/QxTa8zOqmH3ZvWUuez0O2+Tv+4F9N6RgmFEZ7BIUm8zn50KhHrB/e496RNHFaqdQMjSHYRjdiz0HZvj62sL+62wBgewkGnRALdvDiDULeHnAzg94ORbQX337rB+XBR9U8Nh2fPux4ZvnxeyUe/c1DYNWMyuiH5B+BZPgqV3x6Vnx7Tcf8Olpw+OF0VTQ9x2yH2jEaG21KFbACBkqphcmYF0I60LYVsLl0rCu1jl0H41cu+C6dygBD6vicWM8PD7gctmwrgvWpVnqo0slJFMyvUAjQiMrtC/b6rIYo4UAml1ROP3ItencMAyTXjzGyiRkCMcRuutlrKWgKdsQGVPpwCMyNwgh051SsrItJ0KF5u9XzKKUwCD7oFseGpOExCetqvPUIsyjN7SRZOzqycSjRS8qZcZFiXkKsgMVTCMST6inwIWCQ+QSLjIVSwJiHU5wyHTI06RuRN7UnAlpmsVdasFJJ/Zulcd07WaKKevsew+cqjdNLV+uyuKQHGFNNQY4dfPK+dnUCVfo984Fe2C8hGQyLtWES5pYwLPhkoTuRlb/RWnHFEaBwq0nO+TEjCzRpMWKX+gsC3h/enccQx8exs7Wgs/Led9R5SbXK4/ppO3U6SF5ltqkmVI6jn5kkVi1yFPybcRq955hWO+9Z2ctqJ49FOk2xJQBMCe/4V1pQrCY55CkMtUFVeFA2bAV3rni7nSaMcxESbUpGEvpsRmjidFPBcGnmAOUUEO9SjIm5WCg4g7pxqgcDT5xhF3wrKGtXO9SDM2vb5mL35AU1XsMNFOEMkZcynWEiQlOmLeBp/SbbHAi8XCS9JyMqNOuS3XWnuMODapK5erPVQzRVYM9/XrV0zvJispnn6mGkTg4beJ18s7IezK2uilVTEXiFIaVJJZigkz//Zy3EEOSPNNOZvOBGB0bwIH7pRJdPvTXKk5KqzdF5CKcNg45jS0T9trGqGgGsk1p3VLC6OqZqPPfD0/TuAwoPQ6Q7vcn3+SZkmvHY8Oer0zU5ZlD6lFhBfk6PYSwJviS5h7EUzOd9qFuIY06MML+iIFOkMNkGuqUFol7WMYWcxBn5qTyKkcNw/KNtCifSzzwjWTnw7osiY8UIdN3iyUU98NCi1gpp+KRA2PUlUh8DcPqaA4kAurCSNnsHBIiHGI770OAt6Pj7QCOrjjE319hG0Sx4uFCeLw0XBbCxoRlXbCuD7j2hi9XAf13v/pGf/f5AX/9YcEvPzO+//mGp02grwfefuo4Dv8Q+IplEWwrY3OO6GURPD2QTbZj6KU2ASaf0toDusE3Fu7e3yH9sGkoKwgCah4Nv7WMiO8qFpIDwrYxnh4u2B42LK1ld/f29oaj71OsqsjhEhVgaSu27YJts4IdieHp70woCUSGjIkOTNIw4B2SGEzdJteLG0abh7VIAfWPIzQfONwyxTIPu5LkdJ6HCCqDeDCniOeAkNvV4+iYI7gngotmFup9ne15ijrWtiWnJB4YOh8k+XfK5Jp9O2EP48HIHmTCYJF3r6000+koS4kTU73IWQIlVycUBEM4ptnulJ5ltoXTw4Tq1GNO8DPpg+Sk+hzRPkXxEuEcEMJefIiO9+ys1hmBO6O4ExIP3eEhN9Ixoc3vmSQaP1CFpj9Tzcn3TExV+5uJsElvIRzhcKeZ927T+RI0od1XenIT6HI2e1aTXhBXuJ3QkadJ46wjjc9FJ4RjlS/kzyT7dN+fOemo9V+RoSRe8dQI3IRHoab/ceFgl8IQg598nv7d6jnDE1EmqsIFswXUVNg6Fa9SlnyA+vkrcpITlPPp/LpuzkhHSdbk0ooqzUl6mWhPRIc7sop7hrzz+31+MN8YdKuxmFpKHKiss6UYaaEmhYlzyn4ux5gyTVjP2pwkGcYNd90pDdmIJqcf8zlwMnLyJBI8bW4qHhRzcTk2gDX4pMoM9LZin7Jwy/zRJhMl72dGJqYGpFwngpn2MQ0DnIBFitnoPm1QKWUVU/2r/XaTdZbkVO19njeYrsVbEy0mE54lYFPy2qvXwghec1+VoXKq0Lg3J8tehLzp/T1WBCqdZELjjNISU14aSn9+1QZtxlze5jxATToSTVdPzfitabmGWTHM8JrbHo2idDQvMX/QkJ2w6cvFkYZQSsKPSXA7jl0c9dxKs3idI2wAACAASURBVGdb+i6+m0vcpeTzoFd/RVCgwPlei8gQRqlivTxgWRYQmfGyHx3XfS+F9vCqiZNhRAQNA1scUhS7pxXqZ4EV31aoHyp424FdFIcu+HIVfL0K9g687IQvV8KXrzu+vrxBIXi4rHh+XPFwWdD7FQeAXQgvwvhpV9A//Paz/sNff4f/9fdP+MXHK57WKx75Ddg79i+K/c10M4JXbBvhsjUsvFjYA4lHwHvwjRYpAY+pmPro/wgB/v4GJXXyhxfca8OyENatASw+5keaMolhMox1cXyNFb6mG+5eICBJJOZ+jcSr8bBeXK89pto6mduQ9ICyck3Dij/AiHEoprWsGak4U90CpUbNAw+4ISmZOiZGUrifo1guetDWisbxdoJSTXYn3EbqdZnohm99L8hmRtVpQUrdxl6PCdLA5iVRpUgt4o7qLrrqYWjL8JvuBq2jaMXNyEKqUDaDZss0TfjaWSbKgKIWKlGwk2MtXfrgDykqk2QlmQgLSFmEp5TVYrzSWTxRVE8pclSwdCOJ0ik3XlwOTvwIWOmpt5eTIdAOoxG+U5ohjWTTsTqNkARDzEoWISJ68/nNXHrKaU+dZp5NuROzvRSLOjWBMpkpcUfXGSioasYhCrY/D00ttbum0UodmEgoJwPqjITrhX+MO8mJ70uPzu9TTJXSR0LzOp1puXnf3tfxYjL/VTlcbWbsL7eJWWsPjXjtc4E4T0zZN3X8X5m232/K7k2jbtf9syFt+rpKd5v7SWN+ohS9SygprzGKi7tx4Nm0D4StOiAAZQIX12lry2zqCofWtFUYQWIiIS+iEaJVjNFSNO7JYw75gEhBMc6T3sjHiDju87k+mUriddSmqAwmpIQRTU1wNgcN75XoZdY8z/ppeEGS3FT2nJAiMIlCmAYuUb0QyukxU+ZxnFNYQ46IkLRV9CPifIhJtNy9789yu/z6ohMBJmU/BaFag5aUPT3D9cAojdw5tGi+DgvHHDN2coo1L89bprnhnO453CY5B6CAsl+iiTdf/1wPX1000wKQmy+JqDTRI5W8ItuySN4L/SX09EIOzeiQw58nnhGhjqBGH5S1M3WmBnUlklcFJC3BD5i2h4q2XSyVswVCV3Ddd69FewIcrCw1NYanmdj5qRg4QhC65xmIjAl9vC7x5lh0TPmJCUKMQ9gK8+7DDm7YloaFI4hQcQjj6w58PYClQbFQx4WuuADY0LDA9Ma8dTRSbBvhUMLCCmbT5DZu4G2BktEztAuWtmBZ2SbPECNbNI8dVca+B69bLFLY7yf2lEYCQcWoHgszls2mykc/8Hr9iv3Y0XZOLGBcuM25ioEmvF53E0WIptEyp3+943q9gjyq3g7cYQ6aIrt5GXB6D7UIfdDhMfPrerFfd0yRckOLKal3fKFfFxG78PwmHAU9ofE5gdEDEtzwmZurYNmG9MGlJxrdYOH/LlSMQmeTT41Briv03CW7DlZ56HcrQk+L8SSL0Wam1GKeImrgBmyROHUcJg9SD2QihcqBozN6PzwJL8IUCOw/89EtKYyJTjITygaGGzkzvkHFqDakhd2slCsqYgsk0hoYpFXf2+0hmWOGUegOV3wpRDqVX6sFSMvPryuNxK1C5zBOKOefB2Ga6A+/acRxt4y5XnibnOE1Hl1qtHM1/vnBfnQpcg17kAyX94jC5kLmYedKp953ML/8Z2HwnajmmFaolARZZ/trGTmPxNqQ8RxTkR+FemxzYoof0o/3qBTxRtRJ0kjn02wGb5rSjPV2nbGITzUVy7KOYll1LiCZhxkM4XHxcJPWTsSSWW868Jpjah2gbDrzJFPLTSXOnKdJ8GgGcZpuy0gTPhXYrbUTwUTK35mnuuMak4n6EgavYVYsIfVUyUFz7PiE1uvdJXxjyjo3hGWrGF87m/waeCPOWJ/f90pT6dJH4YsaXU5TMatd0+hfkY3IUBvjHYdUQkRTBhHULS7SP0kaRTTqRUjEVSJjwwoqDXIaOf2m5lKU1GZDBDeEHY2GlIZRFEWOsmThPaRIIU1YuEFJy/ZKc1obW5tqohW1pERI+ISGBVe6DSbCpI9i6kXZDKv0UwquheHVwdQ5/2CihPj12oK9TkO6In3PIjo/q4WnJidQdUKDvhWyCZSMgmLRHBIu7c7Ajuc+Su1BZaPhKRduTMSJUjTu3+4pv5yNTw0TIzKZg92PQ3rCymhLSx53P8SqbzZUs0LdKxaeK9/uCae8kdJwGJuB8SGJT8mP40A/eso7mFerC0RRwa9VYjR4pTSZpxvY8aEuw/FhXNCE7Fl2AIdknbK2FZ0tAIgiiyKGnl1cVRGpmTZbH8o3kzqLm1RVw3tofybSaRsx1m3B4jVu33eQkk/Oxcl0AZcIljjhKoSOBvq7n3/UT08LnprgQh2P7cCvPqz45acLPj0ueFwUWwMui2JBx8qCJge2xcyPy7bhsm2mlTl2kO5YF+DhQlgXZDiLiI3nj6MDrIZkaUN/xjzMPEIyTJEczAtOztLl4YJ1WUcgiCr2/gZSO8iN8W0X9nX3RCW/cXlpFgLTWhp6OBiN5eEeDwwzjS5j2hZx5lQxRd2CedbVfp/5xgl/b8qWUzLQXfPJOYa38pDrKrzqHfXO99MT33XCtpUHcq689RYblUbKYgyKA5bLCis3VzrUqMPA0kbqZiY4dogebsS1pq02F2e1Knm4g4ieVqSa1Ix5YFaKMQq3vMwryKCmZJNiv99ypaqFLTITFeoacYSwvG8eiodgGE/He8Np5OxdJm1n4L2oTpq9GOhHz4CUczN1b/Ohd1LopA8Ndhhs5mt3vGYJbFO5N1J3Vyb3uHlYyE1ASvzM5/uhItImA6UO0/R7KLPZBHtG1RHuBRXNU/r5wT1HS+MUYzwHPXTp5eHyPrmiSkvuTZrPps9qrlLcM5ryzXtWv3/F5dU1NJH+RXNfPVv0NKl6b4J//nrj77UT+o5wZmrfN67i5rrAO4INfUeWMv2a6N2vD5cO/KW//5fO57x+i8+ivm8iJ+MqlWEizZuhox9xKEwNVJpk8y0odAgM3n9sg0fCJpLRTjjnB/A0BArtbfDYa9R4+C1iO1bYTtNAh++QUarETOlMb7k9M6cgG5rZ8XXjWE27t6gdTOmW9dfO2QL3zxLMZtn6zC65ITJlZ8x5EKpWOL53n52b/XxN/ZxxUF6/oGw0qeiXQ46kxaflJSphNrqWYU0OeXIL6anjYrJjK03bbKxMb9MwGoeh1YZsit7t+SQShnrLbacR8zeFxAVBZcgAfVOs1hD4PML9KgRiyxfpFOfjnBgsMvxFeYZ4wqvmEMuHSOJb2I4skiUwi82GtEsOTUI25GGHMD+LNob45p7ZxiEmW1kAXiFtg7YHHLTiy8sB+vtfftDffvuM3zwteG6C543w8QF4ujQsbOSDLozXXfHjlx1fXwwN9/Cw4WefVzxtwLo0HFfB6+sLFhI8P6349M0D1o2xLdYxiCjeXg+8vOzYpUGUsDYGs33ICylIO7gpWlOs25pdA5iwNGBrDevaHPEiIBIwKdoCoAFMgtYI67bg4eGCy2V1TfmIRac2ondDxypHH9KSCFfsPaPLo2VSxxLx4sgyMdfSsoQ0xAJmxsEr0yEh0wRpaMTolLhVDUxVnxs603MhUk0ch09TQ4cekgB678Fx0nj23qd1XDr5adZ4h047DyKELGQYioTswG+BOxNkqpdiMFAtere7ppugXFeOMnFTmXSWvJTiaLw3yACioR3XuwUWc8TTSjLJw6zLaxumIJrXodu6TE7s5Hg3O4Bi41Ixc7Pxa+CrMBm6hsZTRW9MjGfywRkxdstQwGlyrFn035c/3K5+YwIjMfkqmtMxdZR3CAU2/RnKDE7NpGBM2EXk9HPqDQUi0Y7lIVk3vhkUdDJempzM/BZUmNJdJSctMY2qGuLcKt28nVRCVOLakzklVtW3foO2lMWHyvzgmwr5kkIXU9SUJGEi+1RUI97Fzs1YyWgSBs8cd7XY94r392Qq5yK5/r1xHdCJS3z/e91DY87nFYqem/6rr+U8wGDQXdlRFN/vhULVJrD+fLGFiuKaW+UozufkzL9uo5pMDKCOJvoUZ54ZCzhJ/nTITkIXLphTMNNwKGMbF2nSKMmcgZds3BCPvS7lHnb5ZC20VUu4T6kPz02USeesuW/csiEQHfIaopmhkl8jriPoZLTNpqK+XxMDnaZhjCoKppambdNJZj60zqLlOXNLRhmboV6MpYPaYf4DmuVkdxq5m3tL5kK+NnNju9rAnn5pcjTKybpq96m1bZa7HCnNzZ9cdUhaTWydmzZ1XGAUzlF8G17VyCI0ZQ3EpsrOJFZHAwpj3w87w4RAySDvJgJABE65ZlwkN37FajZkJjxCgOBUpDFea+Uh6DAEMY33237gunfsCm+IGP1wWVaH+zaa+wU1U2XJM1TJNyGLZ60ws1FcCmz+OBTX/UBXApYFvS1468CLAC8H4euueBOLqb/uCvoPv3vUf/9vvsG//5sn/ObbC54uDQ8sgB54fXnFy/XA6054PRqunfB27Ti64O164LUTdjTsb4zeCcdhxSyxYr0QPAsGIgQRxn4F3nbgy9WoA5eF8O3HCz5/vODDpYG5g+SK/foCgmBZF0cCshXfixW6jw8bLhf7PW40bGhetC3bhg8fP+Lx4WKYGD0A6gAJ2gK0ZrrqOHT6fozABwi4HCJtWdCaXWBdej78kw2qZRILKiEquI2P9oNRu0x0DToFPgxHMRWTEJfwmzH0mDRswf8+6dgpJTN0G8ZymixFU6E4xx3rbSHkq8T6YLS7qxZNemOc4iyUexYA0U2aXGdoK5HpqIcx19VJKZMtX9PMS3SHF0BFJ+4TnuApq4zJcawHUxrA4wAHjemj9YOnIkHG2pjYU7t4pA5G4Zkmr7oSCIINFTlMNa4WCkNN1o7XnKvxIgOQ1DRqNl91jUvFGIdKn9BZa1gpD3FNcNHMDmyH5ns/YsLrg7EWH1Ie3P2U8inZgFpzWZmztxO1HppWHmv9NA+KjCaLGKAl9ZrSDyghm+XQ1ufPzZUGgEkmUokg0BpGjrK1qSSeCMY6PXBVTyvlIg/xay1S3kziUKKei9a4LS03HsGijnvacKw0UYVqgXLDcNBolLgU7joRlYaE4c6wsZiP5w0c3fyZ839Po72il87ruXZbWczoXJTrjC5E2Vkh5T+TGj4/j7WN6d7ZA3BPPzsMbxXLKmULFmtrmTwzUUUks5pjXS+zhOwOEofe1TKjrOupBD/SKXWxjtwHg3ywSDjv9o7B2c4pcNwTzLOJtMqGfLrNGJ/deJYwpmyTWMR58uSND6WiKIMiFhHwzDkhHs+1uXE91eUT/7o2s0Oqr0NiVrGDfk7SlA6rN9dZ4nGT2b1AYwMsWoLIhh5/YDy56vWcriZJ6MrUWgq0XRvNkA7/gF1zPpUNdUDmjZRkY/97XMzF1sxw8s9NlmE1Ufy3DS460Otmpb4G127rmITbnMP+LpU0yZhgB3VHnLJi94JP9XWYSCXkbFO+QAy2uGyEKNUShyquu+Lr646XqxkmXw/Fy8uB/bDtz7YtuGwrtnXFQgRWwyruvZvwhtmaEmXsXbAfNuOO+/44xI2k9rXfFLhSw5/3jh9fD3w5rAC/CqFbn4PlkRU/+2bFt981PD4rWF8AFSxN8XDpaIviSfOesdG+Ag6shhJhvwquu5WtvDQ8PG/YHhncTHNtetaGvnt30HdI72A9sC2Cy3rF1hx1pwLFCgW7RpZMqN79ACdBa1eA3ixtzV3qbd3Q1gtae8B2ecLl8RmXyxMuDx9BAPb+Fa+vP2Lfv2DvHQ2E1RmNqjv6cYVotyjYraVuOYELXDib0ypcyqlosfeJeos1cNmqsXdvrMOgEg9cLodTaIAbDyoEuy4pi/873hKlW4NFRRUy84xZ8wYj5AdVQ3vGRMXqkjMEYBAj9KRXbAVjVINvTO/dEwtpOm526YLj5wiGDYIaFccJHZdtO+EHh4whtiHSfeUq4kFNrUwUT/g8BqQtk4GlTUMnP0S9iXBHo/1+aVDisK1TljotlLoyg3sJkjARB2CEOY0IX3s/8G6MehScE6nFf5A2aW91akToZFbMa6aSR9xIwmHsK9pe0vnaMrKMJFqqu54/tIbJneURHiEajNdlWh+TnxfaZr1643EtdS1Kc5qI7XZNxcrWqUwaD6QOKJo3t+tMSIOFetW2LR60Ew+YbTqjgcacJACV0AAsvJbXpVMRSWfmdW6hiiFVxvWS09ZJouQPehkkFYaZlJnlRsvNJMBCed3Y5KfnfRT89OEfKVJjBYh6Np5SSAuDr023CDzMXhacpGsoZrfKy9ZyjYPuy3LOaYNVyjC2ZbHW7gMBW9//k2k3zzuR6Xidti16XxIQBlh1pK7qGTMY55BMDedoVE6UKppRm7fJrWObQifD76zJr6SgmVpR3y8zmEmZbEu+tnGe2b0kNTuBgkswth1T+rB0m1JqPOPj/SwNaVB4qLSygUT0e22SdCSFqRKOFMMOoGUKfF9WFRPw+pz3aq8QqMaUXFmzKdb0hQ1DJoNKgJHdi4D4ItmbsJBr5Huk46TpUqSiNEkUK9jBjLuB4+2FgS8jhSETPWuK9JyZEZ2tFGJZ3N+x9SAyvnVmdbg3jQJMIZQNy2hK2OQeGBIOe5ZEmBfAMJw1p6nTtofH7h6F5pAKpYyr712gh/kHemy4qXkIWxsZCv6Zq2ODGjEuFyueeTnw8mb87cePK6iZSdTfcXDbU7IirGkg7kc3/KIPWS9Lw2UjPFwWrMsCUgHjitVTLpfFYCLU3Gu2XUDLI7A8YseCH74cWBQAegOuCw4Ijv2A8IGVbcW/uI5FyJB/1OzB4zJPCDr4oePyKKAGrJcFj49A2xY3EhK071B9Ay5+IXdkN2SBPW/QQ9MNq9Cc1C5sDw2CgtfVBO6rddbddcO8MrbNeOHMAsILoG9o+484+h+94BBc6MCyuEGDFrA2NF2xXhqwXaDoIA7TjRWpgjI1LWvCKPhUG1DZ002T4gBnjxNmfVXEk7fg4qJNJsszIold7N/aWCthnFNjGka4Yc+ymxZDD85ngkAprFpbirauJnQNmgXq6+KlisZzKhodPKdWVdKcJNog2rE0O5R7byV8Qco0JEwyLQ915mbXG9g2Gm0ZC0afMsfUr8pHhoR3TNdjktt0RnMJZBS+VcsOTaoyEcyM4wfwzQP5DmFGvUbqWsgw4lOMZMn3jPUOTXrVRofxMgkA3RB/8yTSp0diJuc00HGzZjlOW0eMRfiFFCxeehuUijxF3eymro21B0aDQljcazoYtRTLcpdMiKpnC7mLXGkugMr0squcsFhVI1zT93xrIMjriyoNQcaU3yQBSz5YcfKfZUFYcGIRODSlj7q0ikimqSRPJmYMJ/yUPGrvl+nl27yyxXD220Pa8gYGO1pzCECgk7bfEW80sgqSmU8FmxcNksBPM8Wg+xo6jAKXUAvQ7Cva2FCdpuXIFNAicyv3RasOw4m7nH5mlwTxkB9M0eW3jGeHZEybvFnqMgJNIjthXXkaigTjXz2t2Vi9ti1KCAAmJUnSK1AMpfNr46nxrffy2WswisZBYFqW5R0NfWFgpzGWb3TLNRDqVlb0nl6f0Tj7uEwdHDpimtCeYRa8BxepHpGxOWu3LF0aAycb2izTpswUCAohthad2ihAK+ZWSjhN2a+G3yUkfBIpzyLTVoAIM24wP2xJdB68yRW/N9PYqGMDWDfT2XCTb3hlbDfBA0owFrN9ENBUoR5/Pm0oaQbdiGdUREPLPhmRKYy5avJ0QhoGqaNlkxQyG0wb0LCN14FcCwpYnBNciCUwhUFknYRkRCJITWPI6A0JzNvXFKDVglYC1akCNGVgAXpvONqBY1fI1RPJVWyA2j3mjdu419QbPAWgO5gFGx9oD4oPlza2uA4psCGbh7/lBme8VoN0LLbRbnYGGpktPoPVLz2TQxML4NJtdZn0uhmo5LtPT1iYFNe3K/78JwFthIUUuwoYB7jtWLeGtlmqJFgBsRAUiVRCT+szIHlMtxhyOPKPhpaLeEm39+vbK/q+W2dZjB9Ls4l6W9YQ7kIUuKAB7CJ+UewuCFrWBVvbsFCzC6FfcSjcUPn/c/ZuTbYkR3beco/IXVXnnO5GA924zYDDAWcgzPBiNJNEM5nxhfoFetbP1oNoMhlF8SpeQQB9Oad2ZrjrITw83CNzV0NqWFs3Ttdl79yZER7ua33rmKEUot2BK2pjYEXdGFRG2oTRBYj7AuTifnG9XdFRuI3uhbjxYOgpx//va2IB2Sj7kLEZ9hHSRIIpDjnCAIWTxpQ7UxGkguPom1NfbDJezlpi1gm1tYKzOoOWDVNVkvklmWBwrcdUzAKNSRNDeiwcrGqmOEP8sM7igbq5gUqH19daPZhodHwLRd376Dj217Vtt7kABTlDn6ar46dmB9/+XIfh0tK1VNzYSCEiVn10lmUEZ6byYQcQdTJE4oHH9MihvTRQP1FdG6Wzo6Tipj2iYt1xyaQS1TmObThpF8dYDkSWVqZoRaw7oBc4OJ+r2qiRjDVMMZsRtEQmjevBxJDQJStcMZnwFLoqRhIausixusZixAkv9l5D0tiQ3fRie96zXJbUPdPVa2ISTxyWUzxIzwavhmSO1TBOR2Leh/Fzz5Rw2QpzSUXN2Ow4FGmi5KznyTpnk2mdMX6ivTHS2mEJa93TUZmh5mvRcLDoGx15R3JMASj4T0AWKc2EBSBsm2J1UpMXkXLYa7T47pFeqTF2XUJXb+imy5wcBEnUmKZpyDIYsxex5ocecjJSj0MGJV9EW8xsGgxhdkDhoSOmgM6Ebe4mSfHrmY96E+tZXN/SrFnkGNpxX5AVeTzoCJp0+7MbPXFtQ94Yp5ZreE7s1l/phVem8yP03uzkR0OwgBXBwxHdREFOYAK6uRBkT0A/O0wPhdier5LdjBQOlio59KkjGUeRmYtJRZC3AV3eQ5rMq1H5rTZtnrUxZ8MjwpjHMj0E4ocPCQ2dGtOfnUI2sLwX5l+dU8QSQpeGDn4EafWavMvTRpDZOJSTHIEF3sPOYlGeTd1vsjmhq8RLe2YJAhlo0rLmVF9FQ77HxA2GrkX45X36ZuHj/fOBggWAlN4YsqRMaQqiA9SKNxhRC1gVx/3ojU+dxlJmoG6MUjc8tVuWpQSJwehmmx4BhQgvXKBbT0xWGfI8q2kCbELGsWt41srwHEif/kH6QYwAdZmoIYy5S1a5bFAaJLYdBcBTLXi+MT7JvX+G/8vffKn/7B//Er/9qaLuH6H7HU8sKGi43RjEAq2CsjG2J8bT7YZbNfYuCZo26+YFNEzpGK6hv5ofJHVzpDYDl88xVw/J2QAlHHKgHd3cVcoGLhXMnZndWsOnT5/wad978V03lG2ygJkLUGYhVbcNzAW37Ql1e+rmz6ZdhP/pjk+vB3gr+PD+HbjUbkZqDcfxatrw4oYKSENrd5Ta40X7+FqmgaAdvRAY+mzD0ZRabRwC7+DOvtNAhWkYWWWeqSajF7mMIbJzB+auI9zGeH5SJTSEBlwTBjiRKHRxma0dXgTkTmSKlrQpRHLJeKDb7EhL4PSyugc66dgxI+lPvGRI6uhouAdHhHsO42gLW1h9k4hj35Pk5sINT0lCwMkdvxJovGwl06xFPviiec2cbO93Tf14mqJE3jUnw+Goa2PYxTRd5XvLXeB+OCwuERnympHSmDYrmwo16Z8faA1tOhtARWeHdKAm+wTJxAuBqxsPP16IQLv8ijIT2/Wb41kaPOZwYCwUTLI6i/yIYlTjt7KZnQcmUIz9m06yvReBdH4xBFekIIicjc6xMxmRiVekkPXf3a9h778dbdHEq2cHpA7kYhbLVBY+ab9zSM1EnFFAz/VJjKWSUkCseaUlSbudu6Ju60AkREYuvSAcnlMX19Z7aPBb6ExO1TMNqb8nyYhQnJsP67Mf//+8VlPvSzFN2Na0aGgtF6bVM02F7LVdU5LU5EGXVJCLYCJdzP2PuNfZyLes1ZcCc76QN3IyG6/7/jw0lMvXPwKaiskEkxlVtSeWBhxpStP0jqycMKNrRsElanc1Py5JlqscaTXqPmL3z/9GWSZ22teuiTojOftaLqN2jc85DZK8Qo/JPel3q14GWJ3N85r8EO0Iki+XfoRnyagk6ffruIc6nYRsDdXYEZdhdrUmwt4zIHoXm8M+bTr01v0SPZF3fFY0ueEhwGc0DgECWm/AjRTQkYjeX6IFIdKcZjdpeN1323t7zVq2zXHahe33DWJY6b4PHtMWJmxPN/DzB5Snz1A7YF3w8u4J75iA44Yqgv3+PUoh1Bvj+d0Nt5cKqp3PrSOv3oJDBkA9L+4DxG9GMg1O3dINgHUrnvTonY5DoHfg0B26K6R9wn4/cIgAZRZUh3VZt1pR7OcULhBp+Hi/o7WGWhi3d0/YasXT7Rm3p2fU7dYL1ErYXhTbcyegdB35HVsh0A1QLYYanOEIEKAd3RhC3EBDikMKxY5DdhARtjGSA9DQsO+7995KLdi2rRuhqDMhB3pn5B2od2U1xUnHxECiaqO/QTSZznoR8k2zR6reT2gjZsoGoK5FOJECHi0QEZclKpcLuwQaioP4y0yfHKaU0YH34jByWb0wpjD2RQibmMbT0VUbnfRzRHrpSXSx86I0+cN6sTCFcA7Xz9mGwwtHNo7UVzPN0IQr6YVUXxOPORdCc9EQkfCWeIm8xpQ7YcbnUtBwd6PSeZKh6BH2xQ9pZK51maELwUAnMcZ6jPcPMf0jrskYlNXUw9dQSnQ72etmStHTvUANm2BIcUukCC/OaUmpG5KUGYRSgiE5d43Y74vjQGAg5yCV8Wwxr4Y46jpFOfx5YlopDJpkKoTunB9m1CTZCN2tePjLmyshMrl7I6f2hT/hCiO6k91UmaQtQfZFJomK5lVHr0WwsRJa68x8QEFGiRpGSw1BLzH5qA4stwAAIABJREFUtfN62d/3CC5ZUXNDajcM1dJanySO56B0JrVHjDMlfnbUuQ55Quwkz2KR0Nox+ft24O23/2wwjDTL0XQZh9bBHJ9m936/lLTeaOL58AXWcZXOjGs17s+UVbkU9M3SA3uTgzw05hHGMaa0noqvqz9zQXM0Hp6LzjX06q3mAgFoONAEQDumV8hkPYwDQ7hM1ulUa0o02WfwylosB29BLADbg6J8XI+3wp3OB5lpVY0YzHjgWzGEsyMvDyWg8fNbP5/1oJ4OTBqpLDnAJgUHJlKOpCAmxwkCeSo21h0FDjky6hiTL7/SidZkYg/9NKJORQFpNRKY5QE0a240QEsxoIfiaK/WQBpG/DnRYmLThh9TnqXBEDpqx6M3k4ZvjoNqwFqYfQ2Lh1l7T9u2BcBFbySPPBHins7MpYBqdZ3/YV671hruHwXUDtxIQP/z3/2R/k9/8xX+4c8afvQO2G5A3RoqtIeWcAErY6uMeiOUKgAfUOzWre2dj4l4Y2y1a4ELA8TdhNgGw5kJjSqGw6Edh0snuoGgP+BM3bwJ0Z6w2Q6UUvDy7hkf3r8H1zJTqAKdaWjFmbizwkt1Xe3qnh4FoBCdk6SGsYmuHp5pfGjSvPNUmbDVksww0yQS2b4DvTUW1dBh1cyJ7ZrFZhOFEvSO/dDjxRqdu9btgiVKIcjE5RCiD7s90ZS3ysjGhqaqHddoAQbMsQuWF91RGBfiJFmhIGEBOKHniGansBY+az+la7WhfWNUW4TE9XzzPayIsxJwijEtcgb0TNmLNwkMS+avcSRLWpppes+Gdht68qvkvkeJh/OeaIlO0/+cc7eL4Igm177adVxTH1d286RyMGTBhonOkWgm/CB1p4VCHPWSdK10LtZdE096PUYPHXCJUd9EYKoLnnBeu6iXjdpXIkIFTXrIWjQEo1k2cLalYxQCsOy/jajksfb45mJNCiq8cNhb58IyAn+7u+UVCBzsoXsMWLWlO3eZVLvQbXzM3XqhOKgwW8fyhHtqSYq0wi3ePzKCZsLXsmvSm6dGelS3978ldey9UPCE4jmlUA24ugdmuXOHEZN2AVooIJpSSaMJMRsuy9SAR6a4MX0jn92vl2YqVFyz4FOdwZXuCau6asA9JTdQppJclxw2KFd889md8WhE73qbyZ9wTii+6mzGIlDocedULzup1/jLbDp9tNad3xeboXGSZha8qk6JxFr0x7TY3AxASmF+dE1i0Ro/q0e87oG1XTX1V+81FbjBvJzqBsnXTSSEUyUD75JBQGXJjcjXJzLJvY10cX9MTOWseVzmOWQpDQ/lTbQczjTICbdIXmsjvl7M/2YkF5tEi/RAQxwVOlB+zbJbDkHbm6UJW6db7NClnnEdJsU0P89xkPU6KmCBpbfWUDgFCR7twN76oUjGYdwmzn2P2XoDYmPwVlFuXRazH4L9ULQD0HLDXQvuqqD//ldf6m9+/hm+fvqEDxvjw/Mz3j0xqh54KoL3z4ptO1DKgdumeHqqqLeuTaylQGT3zoWioVTg6aniduv6JSoKkQPMwLuXFzy/f4ZYp3uYqHgwdTHjSKUJ9v2O++sd+343E6aNN0eiZOld5FJLSPyCpTttvSteFpdCBCu52UnmmNM+mBE1nE+OOl36OtnRSTsmuuiqc/jF1ekYMM5l9IGlBQupJCKLKTeXg8lFS6IM+MDXUrOIC2adqYlg4hHEoNDFzng49QPJSFLL5k6OD68dTCQxSb2cmZB8mh0Ad7NrcJaE7va47nXIIQb5ojU3ACrP66EuYbnQ4tHsvHrhH8brkVKSV231ruzQiw3N5tB9Z8KEObWPnuw6vj8Wv9LEoqrlYaelMGwcG0bXyqeCaYz9Rjy7BDRXdL5zKVYjnw+cQ0+9juDjvZFKuyFzID1hMLsxzbBnfr9Mg9S6ecUOSabFSDKlyYGFm7sQXZDDNzxGORWt5pUIxXcuKDTQKU7RdbPjtdA9gibJC214J258QetSM5qbcOTVx873oyIzFwOUipq44cbOd5YaMNg9LDHsQuY1NyxhHCcLxkFUU/hIj2g+8mcaiwPGQznX6R4IzGpaJnER77ge1k6C13H9SJN5s/+ZOCVTQ3LsEAGmZobpObEE1IQ5yWT4+x6kTkiakd7HpcyDrDMguqfHijQ2T6xTDXoY2rZKSXxdUFxiEyPBh67kLEzJuLqaymPBGikrGT1JD0KJsklchE6HoavDtdNJTgUtnWgo7BNTnfI54EFGE51kcqeC/kFYzpWc5GpiTBcJrmtIkDdSZP06upRMxme8P598+Vrj/eETHB7m5jghDUbLINlbn6smMejOfBO0oFJXSc+AWYZn2UOfZMTQk0ub+gRRnMWNZkhgkZ6Wvh/YX7uvr/tRyJ/jAc1gZey7uul1NqmGTp3y3jGoW+geLfV7yxp65sUSDN1+T/M8WoNIgRDjVQ7sxvoudUPdXtCE8c23r/jjtw0fG/CxAfRXX3+hX3/2Dk9oKMcdLyT48hn46rOCP/vqhl/94hk//brixz9iPL8DtqIoBbYwHwDthqPp5wFgis6J5ugONppwgUPY+IjYqCLk2Bl1EwejWfyrHHtP/0IvdkrdcHt6wrbdfLxA1EHo/ff3RbMD5zXhdpRMQqCzkxMLQLYTzSwO50LFMakMyBunzhNjLIxiklSGLViEexCOOqQvXJ8I2J8czX6zlFLAtZ4eeD1pBCkYoNQ0wZoCV3Is75TZBXFDerhm3Ly6KYNSHNfoXIY0Rzt4qUcwwztE8ChW+CYYdXokgqYKDjhG34wLO5dE2kiw5DmydIPeJIx0w2+uqyh2Y04hK+MErwlROE2CIbwoUiDGZ03Z8NpP/HaKTtc0dkg0yyfYdJbBtT8IJSWm1Q1zZZDDTLPa/J2xhS2u542z0Lmpepz36I6Jt2k6FhGT9jKr3zh+1SyNca36DAFiPoexxPF410NSSO+MxSobZSjusrNzQ55odQ7Y6FSjc9x6fGgnWWbSViKKcZ5Hxk+SeeAfEeID+clTBzl9S3Q5Tn6z8wYOEjB12oqquLyFh8kwwD8dU6maVFxR8LMeDiR8ITNNTaWZYksZBbTYIcs2PQ6bO2VWcpR0ZA+EfT4ScxE4rzHBfIxkchvTE5vKhOdx3DPxmYAi3LN6whumpoVmvjP7IYpnCq7TZSRLX4J23qcybupsU/owGFguRRv3Eaeixo1yEfkYitExlZmTOHET2ZQQjedYjXRLjtHz4j78PvJ0xyx36Ydjdk1tpBmdOue6yK5Dqi7SvpKyrU7NqMiVj2jJ6Vm4ONwSPWDVXz1v8YCqFweI8/fFVODB3qbzDprlJkNSapLQkRcSJwNykg/xxUEg1FVLWFmO+YxrG6fXxUG2g0VCmaYeOnMV/H6gSQbTpaHpg6Th74mHNB0JmZMnnnSmChyvh91ngxi3dX24fX0PmzRE4WCSH4TdUs694jLzpkbZpnvtxmuwPS7tY2xkMHjDrLVhBi9QMYILC+rThtvTrStGrDZjKl0OwgyUiqpE2JtiU8ELK758x/jLn73Hr3/5Dr/4+oYvP1c83Xbc6gEyHE4nTjc0ukO162u0HSBGl3owg6p1Jql1KYXfePYGqXhlV7haATKwAAWkhLJtqOXWTxrmjN0PQLWC+QVPz5/h9vwZSr1BQzgAccfYEe5Q+QNIP5kGczCiW/97cDFJ/KRMiFxZ8pNh6hJQHo2nND9FCDwIp3Ga3ceI8NER2EKhcHGRKDt3VMPi2tOgJhZNWSC05xMnrcySucM75D+wmx2bdSJnTEOGBMPSJBvA5DEdq6MWhx754EM2O9nJtpma3neOV/vvLdtYTCl0Rnra1sAp2YQpFIKTZsJmHlUtENIU/04G7m7DfKm4NqEZ7mlo+kdwxDgFl6D/dW14KqAm4jEWqMMISvYwlzKMt+y68qknC2ElaTJg42lLa51/1tBMu98/+8jQ0hNGUu2gTFinMavUykntvkCNQ0Hv7skMlRhyAj9M5na4H/wcITjvx6H5nY25PGad3dcjTHfMT+KBIBQOi3Qqyk450/5MBLkGTSLCiJ91lm+haUD1FQcXrbRh+gwHaChUyzSEBnzciDpxub8uo3w3WWt6xtnWCD+o271QlDpfNsV/ih+wxuh0UIQmHvFcZEj4GQQkGosX7yOxlXTiEknBNzZy4fwgkzFwBIkEA23s1vc6nlEeyrQ03d5RZpGlBtm4yfATW5geaqBQUQjGoakrtumnSyFgNKzhadHFQ6AmbQumYD84Bg0sgp5+2zafJsRuJXnGRAsI13CQUUnTIGin2QjP54EHQoTIkWodrRiaBzRTbldNOC3G0Xi/zInV6vuI1Jmz0bx3b3Ng2TDq9vVNkqE6m9vLSS4lQdN/klItHfWr10OXReoaHX/2tswJDbtpGEGqiAuC2FznOAVTSfgsH3e+lzXac+lMdTAan7wEDC2Jxsx0KVlbJyURh0lG7eoUo3ioPBxzOieMxdZVq12EkvYd1kwbH/vYlziswyKdBoRdIMeQVLUu9ax9v9u0gCz1szXBcScIW7bBHTh2wdGzgXqKJZXpnWJyuTINVYE/ExO701Q6Crf1fapU9q4/qPYU9EJGmNJO6NPDDnECPRiHdMRqxSHg9hE/eq/46edP+PpDxc9/suFHHwgv246CA5XFDIZdB64ECAoUxcxyCmJzffIkIrumqFTTk441rvg4cGz9zYsvw+gUgurRk4SUUFBQ6xNutw1ARVOG4I5P9z+AD0u6LB1PpGhQOqCyY+N+NOoj5w5XF1iyImnPHCTrySt5l64vIjnIJaN8Z0drdP00dNCGQWtsOuK6TTo9TMrqGzIpGWvV0HQigRmdxf/sesTF/MKYPz90FUGz4zhe9/z3Sf/q97xxUkeoQF/1PVEwRox3ff4sbhy15Tqsqaf2osGuNcksXOc4eb7GaRQkFB+xzfF91Oezd3oldSREZpdOfMQ73mtMhxOjxbAtVJGwQrNrayPZPBKYr5nRZUGzzJRRs/r95QUBL6g7npQUHgewoMSeh0O4dtpcZkmcNM1ckQATUImETum27piTREYHcGDk/FAZYPEDhxeS9bjMjaLEcl3PiDRwvKZTP86sc3N3soGkDg9RD3+I1zwbdCXV2o4ncwkDpiYX0SBOU5CmCKHF5Lz/iTBTn25RSC/NSC9JWtGIGRwc9/G8dH6/JHb/KqlQ1qT1z18z33Ah8qem2Ocbu7jps4zYtWRv1Yue/3XRFCcvUTZDobs8yTC2IS8IMwad9NRxTE1Mp9F5xqLmRzEiFU+1hmpQQGkyhI01uBd5ihiBNLFr69QTfU00o3jPLhiBKM0LqTZ8FX66koTiPF/sMT2w7jj3/alFOsUyHYrhNrGQ5DFtWOUQ4zoyYwsJiy57GhOaxTuwGjXPng1K12z9GWdEYpjk+jPKIQ2X4pw4dKRniuxbxshH1KD8GviyUL+Sn1z9FelF49r0K1F+0Lx5tmyssqyAVaUQ+oVAoCIAVNAizYXJQ6o67Ylsfc232vBsyHqdZE5xEGRh46lgnohR/3r3yFACG4xp/QgJc6O/7T08QqXC75h1F3ljSJ4rnkwSJ4c6N3yYNEUUTazYNeQlDsZBgqaDY95/fzfXGsEpHBhL2brs2JHKHZOpZAdfzz/QOWnWLnvdbs94fndDLdQbEdRJLUo9NFJ1QxHC99/fQX//Zz/Rn7+v+PWPK/76z3+MX/zkhhf+Bh+e7vjRZwXPzxZMUAVgQakNxDtEX6HMqPWG261i22pP9GG4+3ucYJU40xlUfHQ+mxHs6XY+xmBKqBd3rBo9BbQqlUava3ZDiCeaanS6FWLGsOZFynC8DokJhxCMdQTtIRbL+Xg8wNEgNjTlo+pcqRpj4XFAf2wtpXSHeTAQ069CYnIjOW3Cr0foqBPmYWdEvbYQUDFO6iNCOOkhAcflRLJCihEn9sJVjZU6KDF0oQGL3S3vGACnxXrV+zHXNNJCWoooNDetq6dR/iKh00C++Y6FgLSzx2dBW6aUwXVwo+hreUwXdJOyvi5CQETKqaNChJQEmRZn7biEGHQz44Rni0+km5U7b9+684sJaMZeT2f/eP80DpCtuV7fjSk0OxXj+yl0xxA6uVfmrIiWy7pstnQyOhV0EY13wjIST6mYYvmaKTvhkCCqqn5AuNIYEa43VoGeGLpE6ww8M79dJxxLWtWTTCL+HH2wMecI+7PcYkzGfHIXR8ZOJ5i+jWFijLzjOeKNnxcn0VpMqrwqFq4RZTk06wqz9siQhqXASNragW6MzOuAa0UM6VnWHkYuVClIDqaMTZzx7dddNXCoB17NnE4amkZoJptrE5UnV2b+GMCjwagZVrCL+4LNDJ4636aDnVHwlAxkihbMcwi5A4GcxNP7IMGQT4EvPdL+Rkc8ejQoGPSiPnwtuKN/I2r9YwrqXKemqXyGJUk6NK/rTDpQLvzrjNu9Nk4mw/oDHfdVEf8Y53gm1EyNuiyeHU4Tk1Uyqhwlp8ukkrp5sFC5JNW4p4Lz/iEXEqu0PDKlgjuia3nBunoGZ+jT6CInI52+uFxD8fTF+AfFk3gGnGR9It10CWHThxsdThkiQNs7hev+SbC/7jhaQ9sFbRcchiaEID0rlTvoo9Y68zt8j7WJYRMcHojHHgL4/PSM+vTUjZbWPO1ZHezITFDBp0OwHwz6ez/5TL98fsLn+ISvPgC//fWX+KtfPOHHnzV89nLg5UlRtx5ms92qjaSaYwjrVlDqNPN1g6PkUQYoLTC9yFN3xvsGZi37wuwd9i4JofCgD5510OmFG1G9e8RmpJsjrFGs9DADDtHwY6QvE1kXSA55Ab/wm0eMmlLgv1KiFUQNWryJSdT1xcQZNafIhcXUjaqn2mE1tegiMQj6SQ4dUk0PADmPWFMbH55oBaXEsc48UU6hEP0gXgL7mZJ+GKdNXb2wGyduDSaZec14NtNCEd+79JxoIlfdjks6xEUR0O+N8sA0NDsyVwvymix3VaBcEgQWnrCP+yiaOq+xj2tRIyIgkUnZuJATnA1Ag/HULq/ZGDtem47aw9fzuKMEAMXNrpG3vR5MNCY68MQuxsIuORM0G/Uedd8yPeBi87wILnl0PeNrfES0eau79lYR+ujz7jSbvJFdEW10kXv0Q+IMBtNzBjc4+R/0YQfw6nVfH8LOP2t9hq+em6trf0VmuupGxsKmJ7/qZSdUTaLhcqUSCElWkHPQk8/i29Y+Y6OpHFA9LBHZ9ig9X5dmwWprEdq/5rhyBKb39KjDe339LrrDI+Hz6vOh0BFdzbqaZRZx0uHNlIt15ofug1TIJxKTXBs+l0ZN/vl88TumLISZ8OhRe6vYTvcRHptY16nQyspfTazj50aamQqWiR85fYYu9iW12qCToPQh0/vSQ1Jc4/GDXfp1P3jEy9/3/bTujrqA5fqYfX5t8z4ongVjh6LWZaiuPx2jZSmTZCIMaYJvv/0er693MErXh+/Sc15ed8ghyT+0lYpSa0dXj4wXhGyG1ptWgsE8J/c2lo1Rn56w3Z6BerMmEUGa4n4/8P2nHd+/Kj7eCTueQL/64nOtpaCy4h0LvnpR/MWPb/jNn33Ar//sHX7yheLdc+tmy1uPfWdmPD+/4Pn9S4/5JkCpocnetdUq4LJwqQ0KP8NV+ihutPy5DJNHtQK0GM3kyYpMtSSrBtUdoKNHeKJ5cMskMJNrdgq1ZaOYh4DeCZtmrHEi7l3hNo1f4GTEYXpwyg0GBY43/EiujNILX7R46BF8lB47V47LCUW1DDKK0gWFgRYtWS4aRSI+j9OI0E1v6YDQv34rI9qXE2VhGioo0D7YBxWK61ACyi1em2aEowBnmseIEWb0XFe2lKZJXAAK6CEKakpvzpXW1fc4RgiU6AHzvx+pi/So8HirCFmLpEeFy6HtTz40DLKCWqduJYc8+iw6XrGBpEH0WBzx14l6McSDwgFh7Ro9KhTINfWPr4sH38QQFrtvNeh3oizrrNeky05XfHJnSBil7nID8oFuhLqEIuiqQCSUSyzeWwexq/shFuuPvm4Yyq9+/pujcu0BPbRMmzhiEUVOB8M8iXr8WcfXHkfxjwrst4r1lYgT0YFrWMy1wS9MQy+oGl0OE753sPnHetFdXQDmoUQtHXDkK/TiQroPSlv3haAnI6+BUH2vnBjM+N6I9ILz/cMHnkfvGSEd1K+TdRlF8sSKiYFCiVaTqCNyDpWh5XOUy0Pp9WH4Sld+9d4fTUqu185c8M3EyHw9/pTD7ltr39WB9hzGc24E5DMQnyaCcxJV3iy+0+rGIySknBJy3yy8CZ1q88Y0at3P1mbUKi8an+f1Xm+H0Qtj6/maT/UBJE8CIdrj5VsDazE6U89yYKpOA2vHjvv9wLE3sPafqQ1oh+K+7zjuO9oh3sR5rhX19gyuGwiE4ziwN0mGex4NoOhDNZkPmCHEEO4BkaVuUCoQrfj2e+CPHwv+0+8P/Kv/+MdefN+2LpqvovhQGV9UwU9eFH/zFx/w27/8HL/8mvHF54K6tS4tqRt4e8Lzy5ONua1oMmZrP2mLG1wE4qgfJvRI5MFVMGmCYhjQbmDeoGDcnt/j5fYOdav91FMVLK+4799C2vcg3AEYPzyAz4XsYM8Eluax7rGVrDzNdpxGgXAzYsI8OeNSTJoy3Mmj0KaUqLZmEoCGw5cWQ0d3wcavj+POwf2NnOCByKEook5BL+RjKKIZVjBH8OsiTm7+zAcDd6KBuLrkpG9AnAoel9pgGrDGdRHo6QnTHxg3Y9FtzsWD84l6LHbS7z8/NBAlMRKSIGk9Ak3GukuUMI1HSSuKqPmfAbZYuvnZaw7fuFwvFrWV6gM7CLJuM5x/HnZorophaGeuE/eOQTw0eeIXumZuEGAwQppsZK6O4wsj+4vxabcSHGE6dIHtkih9uFp0NUl0rhdjc/1jYLYkpJrTScPJPJnDVxzhq03mVDAXSmE967W/SkDsPo2aUhYpRJUPOZSPbGkitkSxcKofY86mES+8l2TM1jfPHDI2NdUTXeZozbXZ6zW5OiCsJIbz4e7csX/Et/+h1NdH3OS1ixYncd5dv/w5NhUMsgcd9z1PqQ6NELDx3mR0sXuWxUipHlPVUUSTPUtpHQv+lmiN70CCdjK95WLNDMoWeS6SDbyrVGdqLrIpUoMsimke0iekSd0E7mm+eKuZkKWIQ1YjMgy4y2ccg9VOhC+64IJTMtmenwU93TvnqeL0Aq0Th6t1Nd5XrbUTKvKq+D9TXei034w1iS4ma0Q95CzKZ2jIhAiQlp9DZnZpb+FQS7hMbx6kZdkDZ2AMPXwe3+qGvxXCd9lsUAXJFIheGeqvapMeIT8PMyxG/lEFG9u7NZiUZNZxx+uB1/u9y2BFUaiCDU3YDvQm8NEgh0yJFXeS3sQHUwrp6SS1/viL6JSCFYYwd+gBAVQquG5odMN+3PDt/YZ/97sD//u//C/45//371C3bevVfgOID0jb8ZF3fELBH0Txn747oIXw3749ULnh3fsnPL8vQAXovza0A/2Uz70IJxKUCtxuG0rtyXSFe5e5yzkO7O0TiC04pFZwT/oMrO0+Ztg/3fH63R1EBbcbwLXhaVNw2aFyRymtd901SCx6ZKchBgVHOxzrNEpFLmTaKA1RpeK6685zlBwVfpKYLF2SXl15YzXfjDRNBrouMF3G07vrwWjnWDAykoBMt3LnFOQ4FKXcKdfBpR1GQ3Vt1UwZjCliBC2jKojpe+Pk3jCS/joaUjoiMZ0jJkLIHfyh6xLNSvoD3YbHf8bXko6CjhiiST/JBqDpN4h0Cg7c3EupQESZhdfO9MPjudN7KEhkith1G8VCWUbRHmJykhFdTZJ56VBkga7TLByjOdMg1RbCrvfs1ytiCyddYGFLW2HCWr2EHoxoZ+PbxpGUISmmXRf9HyXMWZQ2a8R3jfdBazFK1omM5B56OMpPaXwSkhBVuwqH6M0u99U/leOhTJMWWw9JwUYZUUmz0HlwsDoXBjQNoKBknHprMx34QV26nwBQPXn48fdHPyWVcpIPnK6xTnJKKez0FsXZWBaPsoUp4Ftx8lPEs2/0gaxFVYyeR5ABjgFKwRyl9wNobNgMv7ouYUfTUOyLAk1/z0B3whnDcMSm+5f82RZba2dR4tIPjCnYSAjUrlsVcROb32fp2N+pDo61RPJr9t+g/flvo3jV6JNl93uMQ4eHEKXsjCSUPBkGyfbb9NUaQKDE50KekFJYaQEP5GKXemr0/8c1OR/w57T4aoJQa/WshriPPwyaoUgSiUQpuIR2TK7G+3VMIwZ2OQQf+ZI7yShzkjH39fFzXd89XkGtOHRiKf1eV3XPQAyNe1RMP5qq6UWDjZd9mqOel2aScfdMaQgU0qxm0N5M9DwU58uSS3OJesghrF6RkWvBbAQh03VTp6JAgfv9wOurdcDNA+XJlTJ18hMpOwLlbK0yqgwToXHf4zfeelO6VIBuqPQCKs/YPyn+1b/9j/jn/9d/wH/4RlH76G6M0BtQFIcw9KNC//0d337D+Op9wU/eF/zoi2d89dUL+PYOt9L7dMyCwgXPLwXbRihVUTdB3RSlNBQWAEenpfhSNNnbpRK2rQZjxwEiAWE3Q+HAYDU0PbAfClYFZEeTTj3tRoxR5AmUO26QuFNOjn3Hcey+YNRKKKWAWF0zLtpPQIZR78VcfOAHxzUUISLqMfCz+A4peQrTKVXvUM0NJHTkvPNkmmdLWZo9UHKDxoz55tDlyYYx1yj5/k95EaRomiTwMBZMyrHjnWwu1Qu2YMSCbfJsxdz8ekkmigTCxjQuRC13DD9QrO74iVrqRt1VZhNwg6H7P0NNxoNjHgJwqsHYD0XRfxA7idTH0aHajrjD+B7osjOMtNEkdq1RdUZRzYXXvWkFIAYz5zIZCGnfjkbV3AniuKu63i/CFhSlUB+TAxfjS/LCCYsBhxLpQjv+cnzOI6AoMsdJ7VkLeL3GrdkoAAAgAElEQVQ4NbLDXHEe+/x1HAqmuDnFZzWSSOaGbYWp6GI+m56CwTzWoG9XpumveNCdXfXtsGmcCCbVieYTOnjmM33NrpsE1v8IHLO1adXER6MqQgpmKlBjem+cx1AOlYhIyeixIFybsSL2sm+c7KSZgTWjy7MW5cKZHnS7LwDPZKb89TXpMtO67GqHHIEYYqShkdIlLOPPaQBHcrStentjrpXcJQK+VuHM61c3tJtBcmE+9866FbpD4hden7+X0bEmBthIMV442nqsbu136lK8pnEaOC4ow4cg4eCM/JxjepjIi8RhEJSQfOsRZz1TgWKugFwcDuOav5BfdK7RBEr5G+KJ0JOP7UEqmKFifkhHbqTpOv1ETsb0ZpGeo2bGGhSbOem8GWAFE015LSerdcseH9HFJ2fyQQdPTAPnfG7HoYd9WjMfsPksOg2JerNK7fCmxFCWxEePh9t+vSUcBPS0tV9OAJJMZdz/YQMczRfCNA3TlYl2whtomQj39Xo8c/0w2bQbKkUbQN1jUbhaXdDfR2HG7amibIzjXtH2riMfNZmaUmDKaGxawdTDjEJ2jTJBrflKRq2j1gA9oHgFGmFDwRcfnvHzr7/ER/qIWlixbUCFQo87Ntrx8y+f8etffo6/94t3+MWXhC/fN3z5OeHD54Snzxro9g209gqfUTrdhHdrTXVJRq9VGtBkxiyj66WFm3XVrONQGyqxnVQOPwWPrhlb+qXPmFV6uKOlkdU64pzVxfgQwxVKR7/d6s3HfNMg0gwBaJivQp5y5rHpkQMrzU9mcURUa7FEzHNxMuLfNbBKV0LD3BzFO20zKCBLWrzIVDFd6dxExoYo6cQeUWgEoWZaqoBB1MNQOrO7zDyLdVVB5Q0j/c1HnIHnHNgB4RAQH8yrrlnQB0aKg7RgMJ2bb3CiBAlMuH4eONFPncW8AxpGWGBKXVAvAjkGCwX6gD1YCKY/HWR/7xCEQJVHTZYgO4jViOZqLsuVw+eaNk6KyElOU5irrvojU0uMYs4GxEckiiV8KbzeEnBQMHRmWU4QoucNgyBnibZS1vOHZ2FFBMYwDt8gaMiikGVBSuBlUY/d+M5+NU40IRUSMXj13O27+ujIx+3rax9BrIMhv15LaH7dBQWbbdDzmQjPoaxFLC7NVljWhTHuJy8g02A8yMg83qZz81O5a5KMEO+y3tM9w5dPWvzMKs5d6HHBKWoUBgowkFd6wmzwomCEVqk1SDALU+YgXwnpubbf8O3mev5oEBtTmFF0JR71iJinOZeL9x0HbvMIIuqTHV5wiZrWMT9E6QT3wiZTfQyvqNjSmnguXHU2k2CR2TQzBkCh4YB+33vwn2qgl4bNRxSMegplI60oIUyGIrXLzf7iMhyfcI1pkIgfUkfuC2lsVqj5gMIEKmjmB4aR1GhdCD6kUSyOfnII+JsyI++GpFAwDZI10nhgHQjMeWcPEEJ2cfc9k5dnME5grjrKM04+dNdppkdnahpjtJRFd5uWMKghHD7OEVpzfeO+ftteGQlZjIg2DD4sEFSOfB2XRo06jtiadeaQ5HGtNKypMoWhetEsGDKvOSWIEWYzeI7GiEAFTQ80bb0drYw2kNPd1gDhgNMlhRDQRoiVpRTPnJdxkCsYkc1tqAL8kauWpmoCDO6mzVIKwIqXl4Y/+9k7HCA8P91A//DPv9IPt4Ivngg/egK+2AQ/+0zw618846//4jN89aVie/qI+k7x9P4Z9eUFKDcob7173RqkHdj3A2KO8DJ04HqgtR3AAbbXzDzEdTwT6phRrfM7C1d1jrAznOWYRbYX53YyHTf+iG7GcKOHlLHRUWK7ARKLV72TRHQxQlFZCuiJNepqB/LEuOliHoVsWfSSfPFA4KGDe9VWEZuwfTF1Rf1WZO/Gbrv4UsHePRvGt/luSxiX2WtpSJrAqMt1WcGpy81TgrMwymLnLHWZxwSB5hnXC4AoH1jRuNqjn7jEazsjvKdkhlJHed5q0dE3oq1t2hA45V4wXZlaLnOL7WcxnUa1j0wxOWSELqPnH5n4fsiIdWV6fRSF/MjpfqnT1bdHuo9RXHppuMzo48ngJ1xrn3MoyqmaD/eyLjrzfDA5BcgsZqF4z6wcW0XUkxImqXFhXodDSX4vkr5o3nIB9zXbftZBnFOHeMhD6BDNg1rGh3pRc2HC8uCi9GGoc3jHxRAz1evCT9dwHYgINUkI9MGhMKMMpxl9cOr772xyzOS9UXwPGYfj22KjY4IfkfwGEr6n42WdyBWRhm+Y0Ya+dBSbYk0mDcVXTJ0csfYB8J+mXOkl6qxHHQ9pex/7T7arvea6Y3LdBzIVIc0yEqaSphox0U8unpU8gk+FWkCurpKMzkIXlzik+5ryyTYG0fmtZqmGHgTHvWAf/HRElCZzXmdDIumYWkaEqj9WQU84ClwK/qQo+zrHxGctuQaJKHttcl5rIx88/vceWpplX7JIbshkpcTxoBOxrXl9veq6D0TwrB9k7s10sSbrvCqqa+Jm/hyuzdT98PXIgHolE/IOusIzVKYEtIf2qBDaLtgPQWuKdjQchxr7G4BUxxkOXQAX6mnozIAW3O+C/W7fb1rw3iGvhtMkUNmA0g94zeS5YpoOsUl24YpCNzB15KGo4uP9jtddcdANys8QPIP+yV/9Ur9+d8OXG/DlyxN+9LLhs9rw/kXx2WeKpxcFbUcfIwMotKHShrYT7ofi0+uO9noHtKFSw1YFz0+Kz95veP+B8PmXFe8/MG4vRl+pDaXubkwZRZ6XhEyeUDgeNg43Robuj0JJFx6thIIvIK3oOrDhuuCQpAuc/12XkXyMf78qduKpLxod6KGJK//N2TY4eNLWuY7FbZLi8oz57dejf/8usxjNvyNld4X3QqlL4R1kmvH2rl0MBfQsmjRo1ZE2prSxh9CetNCnRAA6HSb825VMvz1i1qt3djR0z+LnRRTMoGEjIT3r+9cI7kOW0f4UvS3nDDpp3vWqS0VZ7/xwnIcciELTvZc0Kl6orZqNKPXRxeCaTLn5+1xaQyc76OM28J+iuaRy2Tl+2+hzPhwTXbR+NU4N1KYbqz9Wsxzi9AIYV0l3Z7pKlm5wiGwmXHQQl2nQfP5P0MClhPYsTH+2KPLGKb4XCp1NDexxMl17W4zC8FTO9Z5NshqfTXv9GXINgrkvdgBHIwV5yhXfmiJ3Ov1e9M5vPmC5x2c57J4mCciRl2RBUdE8uQb3BEFyPlit9wHWuPFVDpMjYoJWLsuleHZykw450qsoa9tJ5/Q3mmuJMBMPaHKjNXXTKR08LvLep3Y7+HiukKCTN08nlGz8aRIKp1jYpuU+TDNHodTGferBQrN5E46I6ZohSX80BPgE4ydladQ8d2hYA0PYVjBKr80JD/tZlts+YMiTGv8saEhSJqd/7uXkssjxcxvW+5TTgbofbhkzXE6CrC3olANHfXyWQz57avRdoGnf0nm/1WxRlw3mw+LJpJrkasO0TD658cAyCxdUIbSmeP1+x8fvX7HvDdq6NFdawbF3sEDPlWCrj7qvUNRyLaxI748fgUpB5W5gZe7kPUKB0oj2Y6AwttsNpVY3I4/ajHmDKmFvnSn+ut9xHAqUDbU+AVpRVQQHFN8fgvbtd/jjd4qNGm4seKpA2bjruGvF7XbDrTJuhVCIu7mSNzAVMB2oG+Hzzzd8eEd4eT6w3V67tAOtk0cqUIqAR6EEtq61mlmTDM8kpoEzFBFa5yVql7Iko8EYL0JPJsduBhPHQDXT1RFCCAZFc8csdl2fF0eDHMS1iMaAKZEZmmJa0FJM8pDwsaKJfMhL6+mXgobbugz6GKulAcY/3jEzJ34mhdRDBZ0eMm+0yTK2WhFkMgNg1rWcLzq2FIIVBlppBhwxLqokk9XTogyNQSfsYUrHscfJ3zwgRUU6UU6qDLrqlWDhC+HAT7KeE8oohuGskhA9ERnWzusaGzyKcJGLQCeXlhznBq9OA+V5pbzQJszzBUbw1aqBEJXT9+qpcKQ/CYGGoLf1wSHRA5nLtYbndHjWR91zTffOozEvhQNU2lilZe5+Gh3Xk+HKqSqkyaBrSu+LaUn+ZDMSDUsDgBZu/zTQxvec3stiwo3yNDJcZ/zm0f1dr4sj5GCIrXGIYzp18EkmsomJLjpoutzMMehjejVmiNTU8UM1T6mUTvUs6Hxt/WOBRdnLLNTYn92AH3SaUVgLaH390QiqyStCy8H30aHSRTwymxhL7zqNga4KGxoGztwDSCMPz3SIRk46ZxOs0qSps42vefon4sHAHFcPn1vNO0FaZvgUssW+unPJ7OqxTJH2Q65Eedq4e4Y3iTR1f0vo8q7rzLhVxx1wMlUrpfMcwuGqpBTpIOOhsAHKlFVEL3ytZ8M/J6Rvr0fKyYitJ1pUUzLcoHpN8sgkmfjtzG9OLa/IJZeSyfFKHshqpgQQYeqySCTT99H0j9kHJKkTTpBdoK17JCoXgAuOQ3rnewfaq5huuwNBOsSggErp6GIFtsrYbhtq3VzeNDx9pXQCipiWnMLEthLjVnqCpZhMl3k0Rho2KCoznm6f9YKcCj7tDd98+wn0j/78x/phA57Lgfc3xlcfnvH1j57x0y/f4Sc/eofPP9zw8rKBoPj+u2/x8dvvoYei08gEQEOpitsTcHsSvH/P+PBZwYf3hJd3hKdnAHxYcc7YKqEUM0WGcSN5EMAoBiXcgJbQhV7wn7td17svgVA4agfhBIRx6l+L5DiizmatcIImzR2cGYK+OOwoyA44e9BDF4I4P0g5tQ1JZzVToILRMOEM44PFy2ZAaCHVbmU568MtgtPG9JZU4REa7coJfrUIvP0187Bx9TviODxvewuxJnQUldY750K2YHjHESvec+xoKb7pootJyfOWEZPnePB1sb9KhbzsAj+4zo8W1LFQDw3evO8paYpnQMS8YhJGjdHQNLj6w4AUtaSP3kfiXCxhN+ev1z+hP56vd8QqviWJeevfh+F73YT651MuDgwcCqLldfIF+/hPCIB6FNizSnTekvdcvb9HvPe3Dk+jthgTI6HzejCUhRxxnQ8mjWq65LfWgvNrkocjbTXTeyeWhI58KL7H+ygmFSS/fmX6LCjTH6CdcvAWhu2HAm9WucEPfS8vVKhHncmrpzzKwOScnzSniHiMo7yKOZ9pvY8j3AOQOnlc3r52j1IjFZPLzWdPg1yh/iRMIPXhkjHNjJNPzgl5mjvnYy04yXE0HiXm72NbR1sQN7NnKkRpRzbhIzUlrj6XmRkSTf4dSPZ2nP0jMstbssBH+7E8CAzz++5KLqndVxMbSj/0zNNoog6Wt0lNpHXs3/EKHLvi2AWyd9nIcTRIIxz7CD6cDbhJiOm5IZHs0uPpDUHYGva9N7e4MJ6eX7A9PWG7bZ64WuoNt9sNtVYIGPve1Rml9KAeRs+tESUcov1gIIr7fUeFdqLAcwF+8lnFP/jtz/GP/vZn+NUv3uPDB0UpdxAJ2nHgu28E3/1B8N03H3H/eMd+vELRsN0YHz7c8P5DxfM7xsszoRYFFwFpg8ju2kQZRTtH/mvgnYYbW4Pm2445p3HtrLcs7MduSNcBpu5JHme4xF8if3jgyziM+ULHmdRTFhE0jTqkF6eCgUOHIWqLaaK+qJse2HSDqsFYE1zpGjua1N21KkGEIFhkGnBfPg2ckw5TaAk6yQXdlQx3c8KQS9O5cE35Q+6irpHCV7rhtcM8Wd5ZNkAegjS1n3FjJB+lKybajedmrZNl7sclmjQdGls6LY53DLSQhBE29UhbRPOnPuy6rgcXnFi5uYOh+lijNwJnhiF2XaDXg+RFcGGi0pwX3YzSnIEfMSrcDqYcfiYyv3iMdDXIrKYJS5f+V0Cr8XVQysrOvT4ErgenMxZ0lXYlzvvFgSa+Zpd9uT6Wl++R0EXjLPVxmZVtzMYgL6fDXwsEDFomGWqTu6gz5iBhczvNNJFTFpm7yC+QO7Kh8eqMQ84QR6JZKDj81I6qNOQssiaYLjZ1XxfoYfX35jhbvPulc+3XIL8J1BwJH9TUDufmeeKvI8rVJn7tUQjQW02Ey0PEctpM92cJJtbLTAYk/fVaXc6pkp702c6Qx6R8neRFmsOHRprsKlsIJ5pZmF7pDJJE8Gqt7GHl/ZZdA3Ci9meSgcY9NRObsxk8wg3SVMSabjkpdO6Dh+UezEbWdPJE7Kkb/0m9SThWCS+MdcmKgIFKkqxn7nMUV0RiXCg6gn+Ik+TMo/yu0mpx5m6f9t6E/RyZJoPAFegiQX5ZnYMdZKRAMAmTe0KmJAieTJmIU+HwG5s1qtboNa43K0MbYz8Ux6vg2BWvHw/I0ePke0gzQaWgieI45mdCONIBqJdmzXTaZYbEFUYpgn1nn16rSXPoaBaiWDrFDsCx90Ta+m7Du5cnFObOApeutBjRLKV0BrjiwHYTVEAhxx23Qvj5T77A3/7mL/Dbv/4JXp6+B/SPEPkEkVcUVnzxxYEvPmOg3foPRYVQv5L9M+pYQSZLH5PxAkYxW8yUcgCtdRwgxc51SwzLqXebIzVpLdMrspppLi4yEhaLrZ32M2ie9LnM8a3X9+OVqCS39eRY0zI+Cy9fKchTrLO+nFS7lXzq99S+j+Lm4d1mXcoU8jOIag5jCakF9mcljzFlRfhcRVyfk99G0URzlegrCIfufHRd263Ko6tno77TWqzT1LiepAi0LJxs2n+eJrikFbXuWQsdbZiDflY/aQMZRTkp+aI/dH3EfTltyISaaEAjO+zNzyaQI0LXNKHdNJph9HJhjIV89hGYvt+kNfo2KN0+a86FTfJkDa5suSgkzgcA31qY0uGVOGsgUwE0Sr0IqzmFFa0sXFzIc0IHy7WN+mZ3+C2d4nXBjh/ctJRmesWZ+BLEtcg+h3GyJ6sKvOszRvr++qTTd4apbqUjgZw+MHCJFHBXXipIdhb4nemFiripcqo3dBnB86lI6jITK/LjVCnKViKmTYLZUK6LgLVNmyR4ZpTEKVUxDBPioSZiyYa0wtaScjU10azh3mU/Kbs7D1nflEABjyd3V4FM6VB2ZcAe090QoRcPURchvUmWFMOWHncUOwaT5IJy5LcjG7mMw+FlmUQaNUf1jLUayMl4ra/NipokMWvg0ygEsUoTDBuXk08fSNcklNJGUPMCUQIQYNFYI06jDVM0LK9pPxv1RuK0x/RP01bLPFQplnAdqw/ojamlmw9dxRKIQJT3zbVqH83ImSJNPqFTiv44//QM6qV9v1cKMjr1k8RYm6bPoHekRZpjKZn8aeya79AkHExz5vlZDD8GBBbpziBlNCEcTbG/Kl4/CY57w3FXaKMePqRjbWSoEKR1XGsT6Xkq1KEfzAXbreL5+Qm32617xBAwo8p4fi4Y6d/3fcfr/cCnT6+OjSQiUOEuvb4dqIeg3DZsXMBUupnTin0B4xDBfVd8fz/wehyg//Wf/q3+o9/8An/vl0/4xdfP+OonN3z2fgfz9yB8AtD52toaWHaQ7iB5BcsOIUFDPynWrfaF1y7o+J52HGjSE7sGkk8MqI6hS2JChXWDMI05o2gnjZo1crJIerZCh3RKPQoapg57cDItNBqDN95vRE2YMHLUVpStUGIGYyn9s05Zl656ONEtRh4mPCi4MiaojdhZHR04TYvNymNOKDb790gGSNox5EVjLghmYKSgjw/xPho2p1Uuk6YOywISiTKErJ0sTGhGqFHkaQKtSZ6xozU6E+NgY7W3rsEMmPo8pZBYF41DocuXJoQDFxcmHgiUmfH5DZyVS4X0/LmsWvArssApKRJ4sPmurvugqQPlEfA6hnT5CJ2KATV03yTCkMudYiXEIxAiSVaAhG8MemO1BV1Dd5kupBSPGqJr7PWU2tClHOctKUacQKwToHP4Ryy7ytwQI097ibh+S66VR8A5CZGsQzcXe+8BpHulcCQUsCHBbIImo9Mz41rm7U+Wgpv9DjADoCSCxgz+wuBtu/EpeivgGzDpxPFpmATMe46cie4BTotERTkfEmjsE0MmIFlPKtrStCh2K1UFMxiXTjKnNqZByAf7jEVf/QL8pkehG9mmTKaTJcLSFbGAvsg0cAjXuvbzBLkQk0ug/FnGg4TBJPq6KP/DxBE6pWmRrBVJX8kEL+p9+eSHCnK13L2F7/WSisQsn1RtvQub1tjlQHF6/h5PJa4IU48mGjFgzK+azgGzmFGRCY8llxgmZvKp4+TJ591xNY4TruU9jg9OrlUNDyNmgY6J81XJzYHl+LyshdkcO+918+kpB3KSesDa8HA1ac7I9sA4oh7IWEqYWgAk7HImOVovlls3hbdDIQeDhNEacNwP7Ltg31tXUggZ0SRM51XNcGkyWz1snYHnvNyebnh6ulm4Gvk9LO694f5+WkPTTjPZW8dTu2yIh3yVAepSk6fbhtvtueNhiXAIIFKwK+PjXfDNx1d8/3qg/o+/+Tn+2T/9W/z863fY6h2tfQPVb/qpRroDm7WHb3QHp51GtEDJqIgOaZ+05wIApYILg1tzzqm0BqbNikC7SK0vRk16gT66nKmoVEBGQUNx5Da4vhN3NS6aamdXyuiGsEwxvIzucvFmyZS/zDAbHkEEyjlTcoymqOsIh7zj9CCXITFZzBvjuTHe+KNp60jBnCjEXETRwl0eG8JaCI/FmAulVLCuP7PNiWR20GMgDQEj8Jj8hgsbV+FwWJnxxDLINKkIC53xKAkInYcDamOJEF0/9KShh5WSB5VSB20UKUI4ESBiZ41CkEJkkuu43jrpCLMzPfW7IuKjNSZ2U+YoOkQzMWcswh6ok2J0rsk3J9c+IW1CnnY2+PAW0ERKJy/BeoAR9Qy+4H4PBRCK+xwQ+4dMqUhVS8tMQRVhIUxqqGAqjjisRAt5ID/pr3MeLs7FyAyHITrHna+Fa77ukg6vgxb0UDevU1t/lab4SHagmiOtR3HdpVEDE1ptUmhFVev+GpEdIjugr1A9+p+1Zt9TplRLYsKcYVot/VebuuFpvpag31RAD5g2UxYZTkeTWbUxn8NAk0id0Hk1k/QvVh1DO8oc6EbWACblNPUA+mvzzAEn2fTrWRzrOikPIs21/8cx+MKSELArGcuL5ZkKdZYOU0/C1DcOiaX24I9JeGoWj60neROFiSQFFGU00CIwsnXQRUQ9JZm8AAoFFvO1djh+FJrv6d6i4mnmjNhJl5G00+fMbIc0sWAzKwoL8YkcQ0HzXBbfklheh6j2kLPUeAiyJhGoPd/tAgWYg57USRmx2eLa+nAqGr0dQpTUBLqN7QvMY7+bz4PoyLDokxlCxQi8JWRSy7rpew0T0rdHw8+7qKNhiDjtduV38pOMZzYG90RK2AjKO98VtOige7YFF89bxr3tEPuMGHPSparY990KV/GimEuXdzzdbti2gubT7HFI74eZdiha6/ePKEEbQ3aBHAeO/UgowF4TGGPeOuz9kGGNc4YV1sWAG52OQlwBZUizgl/EDxD+u+XoAY5iJ35fDwhkNSaEDL8KSHkFuOCuhNYONCqotRpD/ADA2G4VVZ6xvzbU5+eh33xGvT2DBWiHoO0HBLZA4QDk6IYTLqCiKNTAuo8IsMwZpX7DKRRb3VBr71KxKlrbUbh3VsamFZE3sDFS3LAGkIJkmJwYggIFQ+kG4lsvspUhtqH3D4FBtEEsIbPvGdaZNHqKSu96c1EAO5q8Au0OGEVCR04jzRNfl5PY/zQ49Tl30NeOCNFMQXRmuIhp2vNp3x29zMk81pnnNBfUSfYCRd16IqPAH+aARQ11h43QBoMWs7uvGMlsHdeDwLSNaCsG+Ul2mtwYXCgtWDBsUNLz6ywaLRY085x9xNmjz8nH9fGQ0cdSCWHIV0YRuHyiT144T74pZdzYwx12KLs+zf6di3pNOhc2TZrsJONwzdGZsZ0MtQiSgzWiWLPRF2YGUpz1+vEwl8lvU7LAhULxzThldq/VEmXNXooVX7o2P9B29p8zU08Dpo5xMr2NGG73iiAndDqbPY623YQgF0i5OOItf0J3PB3vTuaiK4b6arKjwV1eO/3CINT++XIB8ba0SAu2UoHyBMaLGdF7V3kUn10XMhoBfZ0opV+z43jFftjapgcq04XpXNN0YV2LJw1KTmFjjyQO0S0Sjbjjs2db46xJlj8fiUxfSZHu8dkiuuK7x47gXH+TRC7sX6OLOT8ncoMWM6dJy1uyp4itXHWt437rexR88kBBurbE0D7+XbZPxMlI6o4Gkxv03OUlndg2DU2uiL1c+/nz/XNC/Pp/F5MwRHXNCDkK3eNMKSIL2YmLi5liI3p1NbNa8yq+3/WwjcVYfEXviIX6ONA7BcaM1dSRaucZh1jy5Gh2+LoFlB40YrI7XXxs10bIIUnrdRdlGIPn/dGSZEvuk/L81fHZaDx8iMmFV+fAnORedf8LA5utxU0ajv3AbjSxyhWb7ddUehrksR894A4Cpv65l2rIPibUwiilWv0DHK13t4d0V6QX3WTyD3NH98nKRthujCd0w2VrAjl6kU8jU8XNen0qvx87jtbrDmhv8HItaMLQPZu3m6Vl+nsvFfV2A5ceIXXsDff7gfux437vv1eZgMKozxVKxXT3H9HaR+je5S4CgvAzdnzA7z5V/G//8j+jvnv3hHcvN2xVsLHg3nZo+4TWPkHbR4AOsGlletfl6JqZ0t+Ewy+HnsdpJf3PCtkJGYJKhNYqjqOfivbj6HjBWvqHxSuLeYwSYYE5o1CrECkQqWB+BtHN/mbocKgSQGXD0/PPUOm9d5DVw2luKDYWAHaIfoLgI5g/getHFP0WkL13NtodIs2iSgVc+gjMX+/QaCdG7/UYS0OiX/d0EsryVHcTR+w+Zk0c/MSvyTg20YQUuNl80kdnL1XvoJTQtXdN6sCeabODWE1FI/E0g5bT+Kpj2iCaiS2D4T46cm2VI8yNaxSDRCFwxIpPVWQNIQaxLLx/7ZbzM+loEmhctlBjxNwAACAASURBVBOjz1c09ogsDglnzHoqLKKWPEtGyKcq1yPgc5T7WtjODUsfSIzwZnH4yKgYf19rgkzdv+qIrIVYcF6oXhtwHvWO15jp0JE5lnFlIo1E6kTSywck4lXkOP8weWKViKwFV3TL4w2X/qOfGQ3Isxiw7pocYH2FGQ4ALfl6G+ZvPAwcZXCS0Wg8OohH7xCJdb6ft/65iVZoE6iWNw2C1zQDQin0J5kMVxPrSr4ZB6nT4Xh0fZkRQahh8INI6pmTIYVCH/gYckLeKdIcM+pcl9Tc+M/TsxtliRjGe7s3R6pl9CmIHWp0mcop/GDzyIewvrYxMfDu3cOLH1eEcCBsbXqrFkSubwNqnfTwLAzMZtxHKHS0r+4LQUtNpmj6g/sYJNmmk27+gu+PRe5BYXKLE7/9kdzrLMaJ99H8jGh2VpMkldw7I7Y/UZRdJgnOxTRsMaGPvhElX228xyXw16dkq49aJq+/tT6VhV6t4UHr35BNuaF5wlw69eO+477fe4DgwDCr4oCCuLm3bHj0Sq24cUEtJeB8/WjgB+3eoCt2QDF8JSu4dU05W+zqwQAVcclxoV5xiCra3otgORTtOHDcdzQREBNKJdy2G7YxhdEZ8OiTV5+jDZuFkVW0X5zjeO2Mb/QJQjsE7SCobmjH3pNVqSdz72WgngilVlApOJTRiPG9FPzr//Q7/B//9jv8i3/3Peq/+De/w+ef/3v81a++wpdfPOH55Rn19nknlODA/voRx/4dVF5Ra8XGW09akmIPyuHR8Z68CaDwdB33U1DFYcd9vpmJpvVx4GFjin7SKODWu3FjceyR4WyFlQD6aYajCAGv/Rcdrhe3h0UY3333f9r3Fotjf0Lh/ndr1f5b0IlC0HD090LdqKPbBhJGkeon0Tl7ipts4HgS+zg3uomJKgbEnEyndGjQUpGGbs0sUsncHEPbx9RNgRJGvCPBKTg+PQAjc08b2thY1QwzIvMhCVICMm3r4PUOZGI3aUzt9Dxv2eKs/fADHa9RFmNPKKQCSgpBLtC7UYYmYvIOz5TMWKfC6TRscdIc3OQB3irskplJMVCXXngK2aq15rCxjqS0RZefXPQ8P79RqImKcZLX6V58PRHhFNIGcY0su+pYnjuOeEPLGFNTeXLq9YdQbxcHzKhp1+tDwdVmV0o5daYAoFpwwZVOU06Hg2jEe8NAqbqQgCJq7Koo789r1DHj1HWaJtmhKybKgRbXNAyTv7n7HkDpmmW/D4WgiRxE8xlPZmNNUqg4yklR3qLY7zIlIlYcXh36rjGe1zjMR9f7Cs84tc+8mOqWQm2kS5Km54N4yCw0kWMAfrMjPTvaN5/MXRfgwaPgjQjxEJXx9fP7xJ/ZXmiLe02oxcPzPEz2Db4s6yKFhNvy4Ok1prHOLjJiloLk1EoxRn0sJGfxbOsS1rAYCYfxltYKpmgmP06SwPGCeJGkzUPRMGciNGD6uj5yGcbrig0ass+hOR2n85WjNGQW8HLWxI/PeUhTREChbdi9GxqgfT00fkzV5OjrOnO1g79NDFTRyF7bLt7w6inLPcDNw2FOyyVNlsM4QGhuXklMnKS4Bgzd9mHX0qZRbchNJByUKE9MKfrKJsI4TlPHVAsQuweG9KZCmuA4+n1V0Ce8NJIdS0G5WZz6VJ13/OyYChvgnApbl7t1ESpZEa6MRkDjZjpuW6kP6VIRAwmIM/oLUAC5A7s0fNQDdzzh0E4hYRbUAty2ilsBKgQkrTcU22uXqXEx6SiDK0Pj+wRQ64Zte+pYQyUcQriBcRfB99/vuL++4uPHHfdvGWUrePfuBibC68cDn3bgu73gjx8L/p/f3/Gv//NH/Pvff8LvXxX093/6mX5Zgb/8+gP+wd/8XfyT/+Hv46//6md4eXoF9A9o++9wv/8e7f4tgDtqBbZaTarSNwvqlliUQQ+BODKQdca2w0gNhBYWbjmFzBCd2VR5VDPTpiSwSjXeoIadK0MzK31URmTuVL51CocVav6ApOMmpXxf175yTBUMWmGaAPYhLh1N1VSzW/HNVrcfkNR5jZHvXc1uNxlKkJRomNJFl3+EAY4x7ewGsp2KJMVoT5JH1iFOw6ATS8KCoUHLHfWIUdNGKTY6mpzkAVEjjDvD62hLitnY/Gb4xaSJzMRRxZTjkRtpc0KeYkXRueQnie/tfrNFjXEuUmbAzjVD9dzNxsnZfqkV1mwEoChfWXTLMThKlf5ks+FYHGupc2x5gYL8//cXPZwEXYXrvIVz8+7SDxT11+83F98JgXduvwIRR7l08ym8jsC0Ccm6V++Z0u+dTbow2RgHwSBDOjPOdRqww7qiMcGUxGkG3kW0LtgI/xCdhYqzb5di+TIc6Y1uIqDBZMVhfFtOuQkuW1moEolCQ/jB++PRuHylZkS83BVx4zLBb+k2nidHGW03u/CU6RzLrTX2p9jpn35vWszFmM2B9uDQrWeXci8Y+eFh5Oog/kPP1NX9cX6OderEw8Qjm6Dj9SObJBJy7gAcUYzFdF/G+0iHq+wdOR+84NP4dN8IhzAl21+p5OdBg29hvHcLKCR3uc38DWY20wSAtqQ5g05TyE6N6SbFTopr/rNqKSi1TEM8LWmy7nGQARdfPqeznPJknAyTE1GxePbDDZSjsaSj8ceMp61LSWrp/ySGBc3khG9dwUlKdg4YBtBel6nLw4OEzhpoKtk0LiI42tFZ3lJwvwMfPyq+/U7wzbc7vvn2wDffHfhub9jvryA0vDwD718KPn9f8P654uWpgD0hXTzPo7WKeyPc711eI9rZvkqd8HcXwt4q9sb47lPDH7/9hD98+wl/2AWfWveVNCHsTXE/BJ+OhtcGvApw3xWvQhAU1A+fvcemDb/75iP+1b/7Hf7y1x/xd44b3n14Bkl3hW63Z4h8C22foGKaQe6t9kpjBG8dAj1CqmTv9rXWXa+9iJupZ70ol9Tdqxv7aFI0+7FnMTnxZiVIBjSYIN0uxhVABVfybm5vSnYpBVnXuc2IrmkgomCxDFLbONn2oBvTpKt1CNTHjs10eZqZu9Rh7gil8RhvNYXFuJAD/RsOMBXr9A4OrAQZBV1KEnxhoGD2sIcIA+Xlm1SZvhHrXhIjmMHgAUOpKNBY9AXec2LMxlRGyRCUBQGjQc/ITsSg05gy7mgjXXDIATTvZv2krB2dFXmzSbPvv9yuK0/ChEoe/bmGkZZN2gdY1xv7ycn/Rrk6O++U43jdoDqpEamGVARt+OOky5V+QABaO3yR0+U9XOXcrMXrVakYg3nORYBks36g7WTiIK0D07R5n8OVLv6SC2FOJOEoziNnx0VOI+f4ukrxdpExmA5Yy+u/OMR+k2ogcAeyPy0TNuSCBDSMYrPTqcG0p0vq5OTzqpMIM6LtnHR4VZSlQ+8S2qFuQN1Oo27isAOrJCY6G4rV+3QmyVBIVDX2ayb6UDrl+4BkyUicbORCMGi8vYtOi346h2TJoHoQeaGsivTFXsAthe96T/PiQc0+3tDxH3ptFv/M18/DjZeqXjDF6cKjRsDVBOPKJ6OWapwPICvP3vSBlCWTa4Mgm5vXIDukXIGMo5weDi8Ux+FE5IJjTT7R83tAtXek05ud6dMae2oqSYZJRuXxqUkh1IGWbUOybBPnJjNsKMjZp4l70jXU9mM1ukw7DuxtR2sNtVaU8pwnXY7TG/XHeOqLa4XGajKkPLF+ibKvKEPqiY4tmKa7QbIUsgLb/HlBbusoUR2tv3mdXYMgS+CqGXlH87RPyjuGugS0NJksRETR6MgYRKrY6hOwMZ6U8fIM/OiL3qgUu4de74rXg/Hdd5/wh99/iz/8/nt8+80r/vCHhu+/4y6dc2VAfzf7vuOb/Y4/vgKvrw3HAT/wiB4QeR1E4558uTHKxnj3xTPeQwyLqCjo0phaqXP7K3AX4Nu74L/8ccd/+K8fUZ+44POXJ/z2L36Of/wPf4Pf/Hd/gfcfnlHKbqtN/2H73uYNrmJFL6PL6oerutnm01BQe1e8dJcf6WEnlgNHO1AKA5WNojKKcLWivuuJC8JNhfGZ2GY1bj5VD7uQIJcQwIxG9iFTeJhHwUoFAz8za6/RHaWwFWr27vAMnelufEqj/pV5yjHeeCzWmpsVQ686nk0e8bqiflhRHKlbcsLtLYsZgZaB6rRRztQ3mhHUJOfSz+60snZQTqFF8JjkwdjW7MucGCrYPEkuEkpjh9wPYJo6RuoEBA3ObvihICdtwk7N5Bt+1Oh5uABF09409kGRcILdmzBEuSY10WnkYyLvwJw2XuAUOEDI2kS62vyAPHqnoU/TrOweBw8NkRrm/E6qRr2WRcBCUpzRvahKOMoalmAhUjpJc6Ju+qpDORBkg0rBzGkCtfo9vUs4IGxrUppoGHmepTFKJb9fUC6+sw90ORjOKUNcKxCnEt61URBLMpclXTybFtgDYTg847IcKFuSjg1UPFmhOLBXik5EoYhbnQlU1gEPhwhCCE56jFu71qyrTyzHOuBm3TGtUw7rUIXSbR7gVQbKBMkSbrnv4z2JHFDsLu3zqAhcpEO2GZ4gFiEdVaZu+uPiNBgxJMKY6rnEZTmhxZhyyHzmTjSiwIGUJXI+mbptajI+E/85kjuajs61CSwHc/RaPDNNY+Jqkr1MzzTt+PjnlfxHCUFbbP+M+9hFs0DJpsh0PmzkKQ5dSsQuk0HpPKXzsB0OE+lwoR2RLjhNcQVi0kHO65nOZ5q0eaEXjcYKcTnU2OekEx06oY0pGSIn6bcfMI99+mUI3O8nZl/fS9lAtw2C5/RZuYdpHBCF7RBhgAMzrXLEn9ovZ1Awo69m175uttbfB4FRC3e4hjS0JqiVwVy7JDikgTad05sZQDYMtPZs89yLuwYdxo4nXzPGqxwHE3IAhFFEjoZCT11uYoeVsdao9N/BPo04HO+8VcF2E3x4AX764/cQeYdjF+z31pGFrwfurzteX3dAgVKq39ddnjQasWSkpAPHfsfRdmw3xruXG2pl1G0aRVvrspSeL9M/i6aKXXa8HoxvDuB33zP+zbsnVFVG5Q0//fqn+O1vfotf/epr3LZXkHyDQ8Zp4I59v4NwB9ANlwOvo474MxTN0G1pQy1slL6RPtkd+433ULB0rRCVaqgpuPnDT1BCUBOxj3CTgQwk6ZAzFelr1OjMQLtDVXlxes+pRowVnQYenrq5Cxe/j354ZZGGDqIvyoPQIdNNayPZ1sTHcxxv2lEMshUjTImiMY2VZMVyCADRWABgMR65UiyExQxXtU4T57S+J6qFtDMHuqzaYg3mHtKQ7nXmWHetbzSgBU140H6rjBQ2cu+KyhFCi8g5xkOb7Xq6uFjr1HKXUmc31l5zw3nRFzdSwdMe4ZrOiXc66acfdZFUM9FGZkQwBbTepf72YsMtoXN55Zz3uQ3Tm2P7ExZO6eL+QermJ4NoQIatcekzjAPX5ibKmmsNVIxsIBta0eJSstmpnj+96xEpkHA4Hxh1tR3xUmXZn1II+EJOa5zhXQRwBbSaNnzrUyZVMDVAD8OCdRnefEBNXqIzYMKbGiOd0qLSe5EQY7anFrqj0rXHFkPNa4BFutVsHRNEWtMoXnLS37XRMn8OnMfKnmapQQtv3cGh5USD0u7F5rRddYSroPTpJFWANpTCKEpAOcC0Q7Gj6QHRV6juKGgW/y5eOM11g90MDUWS8MA+T7JrNahLjohrR0rBzbKPec16scQ+jR0BbWtuAuEt6VHgkSNIFGlO7wgRR5iTWN/Stkc5Aj1ICR2fb9R4P/KQxAkchbX+yrR9OrSLJhzqlZwpGplXBOcqcaGE+J0o2WgiXSVDE1k7+NP2XJF4w6Tv+zILOokjD7ZEw4KYWD0m+iKCSj1wsNgBf5j5PYFWEYx+Ew2rhEX2aKWo0Nx/JFCHTB7SDdU6Ne427RDIaR9aZY3jmfcJgslI8j0gnYV9y+Zkl1gJWUBaSZNw57lx9GDwTJZFz18pzL4O8DiIRFmaZRSMe2DYuLo3JmQWxAQvMz6O/gsRz/wJ+1xbBdpGnd19Y7SXitb6Ici9GtRpK6UUEFNHH0rDsQOtbd2sPohbKpDDGqeePVMNb0geNAliFGLcmLFBUUhRDxU0Bb754/f4/X/7Fn/nz3+JjauNAID7px1MHyHtOzsZCerWwACOMWhVBaj1ET6PLoH06GQViOxox+4PR6HSi3RYuqBhYLRItLLPxcZOIT2Wvv/ONo/mQSNO3nEdCyPHUJaRNOmjPUkL9Jg3/b+MvUmvZFmSHvaZnevvRWRGTjUka+iqLnaTkiiRLVEAIUAQoJ2gtRba6M/oB2ongNCCkiCC6qa6qmvIzIh4z+89Zlocm86516M6gUBOEf7cr5/B7LNvYLf9ZzJ7xxR+ekfHSPWsFpGeTiNe4zZxosOOTpAjD3HRIdIvE7nsI6YUNfLcmgYuyYFeWHLaAqIgK7MojQrCn2jcOIzKyJWq0poq7pebuCcHLAtnipCwQXnTLK7TX2uoka0wbNv0yqNhkRotrxEoxIR4jXohEfWIXlddRmvhsDA66qPvZdyQSZyTy44O/3IpiLRe8BypKNYrOo0aKjORPeuhHstyQoa8MQ0HmAcUht67cWlpKuYnsQ2nUIowp9nF1ijBNNkI+gGrZyrMSongcvktvurul65r0h3SZnJtDh41MXFpLSFX3vw6tSv1IZXnu1CWArmvPFFain1bX3ahjovX7Bmp4TgIpA3Ez2AvvLHZpmGjgcjQuOAwr+1RjLOjNVG0ig9MB20PyUOkUmg2L6pdAGhe0llsSrzeeO+bTRV5SqALoaDIpKOo9BNfV/PlLZNv/Jj8AHMSjRgnXQOgCfoOlRjuKDwYTrRT1wbFzNAvz27WoGJhODJxxZXK9ykF7bYIbp+gJWru4tVh/UgAcHszzgMPISkgAiHHlf5dqcrwCQ7dks7nDVNQ04IOZ1x3R+ArXaqK2adJ5dQ496B31Lj5mKDJ4Kea8vzPimmH5Zsu04+kNuS5YXS62Lx6Svzii0C1LOqu0ifLxCSWZtJKvQGhMmGJcz3oiDMVq07xWuNZx2O/sbnTjH8y8SAflMC0UtNJH4nX1OfPp66H2mId9q5lKls9wjPfgVDEn5DzWWcBL8xpITrpFTA7Jl1Nrq60NPWZOzWpS4ccR5yd3gD5vcKliK40JiJCF5rOVv/lIk1Yoe21CWmzuqkFWo0KkNTJAwDabIoiXnHRogOZhyhZN0k+d+Wc9DPh6WYAXvfcGTXv8CO0XiqAdI1SdLtZdszWzNd82HGLTQz2YwQCDRBks++XR5PRhgvesR9QuoGx4bM3G775omF7vjV8+e4t/uqf/ga//uWv8Hx7i42NBL8xNiZ8/vYNXt6+xYf3v8X99Y/Q/oouB4hlIDxM5hF9jDHpoYAcOHb3eTQ9cYwZe3R0omwcoBYIgI9fJ+ssNv4RN/OENW4SJRJcQ3BqeErvQzzgqLMvLJRo7dlKCtj4NtDIq5hXzWCI7JzlAuFbDrsCrm0bTdHvlQcXBfrqYFBRrSUNbhYAZbzy6rbQ+zwlP3tgzzzDVRBZvWSDJkE67YZKgVSt/wCzbEwhkKfXjTp4IE8k/JB7unIZZ5GY2wNR4WqmsMudYuZxbTNzfjp9V1U5j/rzFg5yjokxoQ1hN+bcbppj2FGisev3JCUsYghk+SFX0w/lq7RHoTGdoFMATCFYLeNcAlkqn54OX7kYCV/9t0XYb1OeGZkfz0dxHSl/PX6O79qCU2p6GopOYSCUPZtBzSCMMwefL4jicxqq4p7jZwyR9qC2DscfkpeUNNtFwXQLZ5IpOtsLka52xskcX29a8gTspRTAI6RMpZeiR8vvvUg/dP65ZtLuKBqaPSM6IY11HT6MA9drJDwbdpuOBJWDFi/sfP+qPZumaTS+uHToYypMNlzdBHSzALHFSLsZzWczhH7QOkY53YDbExo/Y8MNwDOgt4wVlx2EHaA7pL/g6C8APoD1XmgPOs0aw3J1EtdhojSskbWnPVU4qQFQMAcQVL+z5pPA1golb6aIhPVdnEsIx6k62Zo86g08qY2yqlzSGKoDl+osMEwgRM0Oz5tLv3N66idiylPwa5kbYzmZvdJJJ5JuY9ZkVncxHdTRBpjTxfw6mTA7PFAGqk1JUyke46ozlevqLBOdp8CTCFUpmrPGm/li858V7j+aKHxKMFtDx4gIrY07t+rzYu8Y33s6u10jZgh11jcUOSRVBR7NMA80Uk8C8iKuWpK0zdYN1UK5svhaa5OzrnryprOZqdl7NPBUzOLY6KvcGo6jY7/f0buzNxq4MbZtK+nkbDWU1ZS74DgEbT9wHB3Hq2UfSIdiCD27GszcbiOLpjd89/4Ff/f3f8DGBPzpj3/E//V//jv86mc/xmefN7Sv3oDpFcf9PY7jB8jxJ/T+HsodT0+b8V07VO9g3g2I7CPBxcasA/mWCKJhTqRBi3UTABw7II3RtNnvoyUgZGxQEYHc7yCwcUWtUzNea1exUIktwnScXuDd3ISsLRZjHC4mZxrBurB7GlVOYUHrCF+Z8dD+7BMiF1zRE6o1F9EkokxVchZNOgmGanBC8n6TM1sjsrOZuCqErgIKrsegHnEtpXBV4+qeeZviTZnWxoUXkRI/KMq1INfniz4ST1GoSaZbeIQarP/tEZpw9eev/HlXJ5RH/s/jMGwT8lj/31WRuoqrhkPM2QGBHsUzXwjsZiu2xy4ktQmYfHn/nIuCPka615/rtmetNeM9K9qWFzMrhdhZqqiCUrxG0ZjVCzDT5GiZEqkF84Bq/3gf40vp8d00GzGLVjcGtrReMiqOpbf1bnuz6EYK1a6zESMcDJBaiErQG9yKLdeFToFEtAhi0yKVsjjGPMVZz6+6R3mhOPEFKHG1FsIdiHWaluipoDgHYV0JPT+17+KzqF61gNZu7kYTOuw+2uxZfgbCl4C8GZQi2sDU4nsS3SHyAukvULwAegdhB7vO6WJRD8rRmU+tVWPyj7L0XGPF7f6RDGPzIkkWbQlU0ZVSh7M8W6eNVVeqFSHPlNNyLk+oJS0T5EyE1CW0Z9Y5JaWrhx91M5pHdQapwsFMZh7e+BV1x5T/AE7ai8pw+vL6wniwaNMUFbPI1Aq71jLlM5/ZjPZCdG6oCvlItdpXFvDO1sGgKEgYJzBVEaQ8dJrxfTaj0y3+TC2kH3n2i4XKOOCyFvS+hydrUNdzyQHP+UhAr+aAtKQ/+S48emgy3NVt8N+N3UAOkkhS84iWsWtmjDAoMzeUSh00nPYGfWWHiuI4xApsBK24Ww5Cd//u3vHx6OjHMYEAjQHebtianevWGLU2xJ8ewrQfI21WjgN9P7CLQME46MAdHe+PG3734Y7fvx7Ybu0Z0u/48PEFf/jjH/H73/8WJG/w2eeCrb1g2+54lVfc799D5DuwfgDkPRrtYDpARj6RfkClg7SDmZJ3Ez4oBbkQWfhvQD8AlYbGHr09X+T9sEFjFIuj2N22W3QmjTIi3g/gI4Q2VLigzjfNEJcaIpBFK80853KQcEHMiD3ouE8RtaAlrQxzul1MBoOip1jjXb0Qq+4AkXhJCtY8OHhC8lOsuApeBmJhHrrGXRFJlnNGhmch4cX8JI4qav0qqgyP07BFpBLDpEUDryW2l5PrXYUwlNxBR849atfpMc2nGNSS0F+nEKEy50ndreu0oViFhao7LhUpF4fGunCahmqlIelM8wCVwvvshDGh5RcNmV/iINdO5ISIVzSRFrvHRQzso+kR2ywDIUM2cVqUrQpYdPnZug0VCQew1ca2/CxYQihNwRS1CcCUlHqaZtibc6utinCvqYLueb0RThzyDF7SamlbNMtaOMQrarZoJ3j4DFdLUQDY2EWuCKrIYbHJbBS2sccUICxZRvY8xcG96gkvwVme47FNoO1FRjc6hqYDjI/lSSgEmvnh9aHgstJNqsPJFYKWYkWOcb8arz3dGNKXP5oZSYqVr6cl5LCs3dR4BEeaqZhg0MTrT91CoYCJCdP0FVpCPsZv+RO4/X+TkFYn+5FBBGJNFAxU6TPL+FANkPLnXHzexNONdQ6uWZvd62K8/JlSiBIIR9fpPPBxPQxZ1pqiqTSJ+dQSRuLsYgTveeAGOp/yugjCPevBRIdawsx8n0XgC63nFaGpFCZYbZbH6wopuoMzdo9xMzciB10i1j3ppH4luqe656WJ7UsSzE5g4KCJipk5sHmzw88rp8DW84w5hO0UMz2KBkXL3Th0HBSR5rTx4A57Aa+CMLOVGoxXrMjMF9uLSNGkBZFR8FgRv8cpTY7OS9wDYtQMdpg4WAmKBBmA8VrN6yfT3wygkqd7AUQ4RKd6q3JFfHuKmT0McCnPkq5Y3JjSRSf45Uct9Mu0XtJfp4tYkJhAIw2zQ/YRYf96P9AF6MI4esd+CD6+7vj4Knh57djN55uho+jmV7SN8PxEeH66YdvaqD+xQbtiP/qwGewCUQLzDQ2EDoYK4/Vg/P2fPuD/+bvv8O//4QO2P/zwAdt+4H//P/5ffPy444f33+Pf/Ovf4M3bz6D8EYf8AMUHbE+DH4O9D2pJv6PLHcQdbMWteyZq1yD+dxXjyYzDsvHg/QyPbR9rcPDZulAeyPUQslFGuzXctjbGpo5Qm1WQuvuuh/5w5Qn58h+jrlBmU5vspULtWgrrQAfwYLzjl4VYgaw8FxjVTmVypaIiXNHFB1Xn5MqSkObvsyJMl2KprrhOXzwjkdt27eU8BR25ypxS7ECgWWTXUtykJJOP73SIAIttli7S0Jn7iGaoJV+Nm2nx0Fh9mZ0aRJPzCMdkYv4iZRGqzJ/BqetUnFuKgEbrQa7F97aOX/WhCOoK8SLOcJXJCeF0QS/JbzVprVKUfJJnU6kppKIKqop4GItn7qesyk52iiff6FEINubUTsSBjxMqGvSudawcFl1F+HpKH0yuchSiddpihVDQhMLe03i1Rk3QmkcgOo8/ozG3wEaVQwAAIABJREFUooU4VPgURVbC53KRhE5Lc+/Pc5yNbbHvXAvfnIoQ09RIqUoJLKnDtvOk5srfu06uLlFmbwgt94E0z4NhN6sBOoy/yycmRtVaLl2ZsGon0o5oEaphsiOjaZxd6XwcnOFqZMXhGavBaRabfricCcwpvHaKiPPaqdImjd7BiCCzVUR4RRmo3N6Z8jAXIydHEykTE9ViketWe4tTjyYYFIxu1kkX0GY/2NKseNK0aSCUi7B59vfWYj1bv1d4Erbb+wUFMxLRBjgFt9QUcxoZdcLRD6geUTyPyakj+8NzmqdJTSRZgMylDUvE+7AKLg4+irAWFOmWjo3JWSbPkhGv7roj10pBqv6Fpvuv8QxAEg1xtZh5xOmusDNdtNv5ZBbGSASZLdiulYRPR5Cld9NpcSS5bpT2gNlQjMK8S8fT7clAMZlCioKyhZyi+TRACs3Hi/lePMKzplII8anhJ4uev+/7ZO5AOltN+vk2gnL4RCbwUL5h39jDjrNbjHyHQGgbSeftGUId+0fF7394we/fd3z4OGLhQU+WWjt4/zcWPG07njbCMzU8N3v23HDvwMshuAtwPwivXbF3xa4NB9/wp1fB7++M90fDBgioEXbZ8f2H77Af36PdPoLxgv3ltziOPwB4j1vraLc+eIntCdIV/dDBedRjjG9UTHQk0a2wukeUjcNEgLaNokUWCohoiRuehVhkvuKE5ImNMSmnsEQHFCt26LM0+3LnwjoT60zUqBQFAdmBUlb/cCtZkUpa7jB3WnGFJdIXtiLkXgh68e+uFVdJcCtNYLZfKp7WV4UQmRAW1T17RoNXhK/aB868z4J8trwY+t5PyJj7o6skuhMoqc4OIY1bNh5SvFbL1Tk5oRQ03rxPYrTlKKSzmQi0+BhLKtopRaIS9JpsdhzUCVW5P/+CXCWnrawlTQaiyowuguYCbtYP9FP5HNxQqdMezTj1qCuycXPRLlOKc6sgsRphB3daKfcoaoCPlvCQnE6oiZSDVmAHmpiZ7bDVdJcfnYWjpfkS2185QUr++xq6YhhWEdQU68kV2XaONxXEMqhUvUQMzxu4BnRImRqAzr83BMWMSeyV+1PCBYrioi6XP80OLn42MBginCJQJOKKavMGOqFJRCtF4bH7Q/VmTurLGuySTeM159snBRy+uoNHKVMxUfdfFFzQYrc6O3PoAw3BxD8WDdvLVRtSqYpFxWWUhwJ2kJTJVECddndgLhTJbOQmka+tSspsh7MyOsVoXtc35mkMH17MSBQ7xHsLFz6dvHKCOWiDZNa0dk5rAU4CTTfgpDYnfmWHcPwqkCdtJtj8lSEIk3JyUSwKuOBTVWii6i7YpDxDNCatNCa4yhBq4Vjlb6e7DJfDPww37hDZwU7XKILj2G0FyMqmZ3Wi0TQS4DRhqPt2uAo1oyhWH3rf4yUxVAyh5aS4TTQ3FXt8LSkUhBCRV8/6sCB1a2M7m47jmFD3SAUtuRM+ZdZe6BvWRFSxaRX3e+hcdahyVHkktw5UF9Xh6CTG59CVxOsCuJXP5sW49D5RYysIVLMhavhf8tR9vXKhBFG00UwE3m6D39+A3gztfxpiyft+4HaMif/GT4A23I4OZuDd2xt++doN/R5aELFz7pCOvQ8Lxi6K17vg/T2dp/ZD8X4XfH/v+P5V8HIIdtHRUPDd8FDFV5/dsL15foK8f4Wo4sMP7/H7f/h7vH//I/SvbtD+R0j/PYg+jjZQrDtrjBs/oW+DaqHYTGnU0fsxviA1yL4xmgIkg+c9xgsHttuGtnEssuGbqdGRxsiGM36ZnKqlgkP6mOoxo8HEmtwKF9oX1KAiBLeZCwqD3GQKCg/KNQUvC4Ma+ILZiuzU2SdIE97RPdXZjtLpBaf6kcvD5V8FpT2ljTUuYRKYCl+eeFQSHA6FgmXmvPoY+8Rj9oLI07HKOFFWVGsqlTT8O933t8uIym2cfp813Y6K75fa/xtcNAm7SlEb/WvaEhFVYWMvZjoSBVQe3jp9/6MQy0LOPVzbSKMJbrxG8d7K964R116Fwbx8zzGzIT6JZ1UVjTgvD3+CgWBz8TLO5mDwz6qtnZZJQxaqPEmUNQKUdHHwwYLC+MUy0KHxoUT0hDyQu1Bopt7VlNOMY6eFb12LXo+V7iHkIaaiQ6awavRCp8sRl6J71A+P7BpqoYFOnwgqdnlGEiumcUDhbjKmRD7N12LKiOXqzV/DoK70HCjNZQqcVg/1yumuqVhzouB4vVZ8ka1QazA/epkoZlMwBmEpvKlQ32gSl4nKmKAwBwLn50rk19TkOugkGs/v73Gq4iP+98pPrsVnnZqi+oKU1Ep3lcJ0rs+6lav3kY4+FSCaecAxOcMALUQV1X3cKTTiRb+j4/ads/sO18Tk7LJNKCrFuWoOmYuzztYrowTRzfywAMtU85zt0xSSIcQgHIFu+7RHV2GlLl7ztsak0IW0uOMM5NvvZwkPbAp6KU26B1WGtnFXNJvejSCyUmAX1zOy4tGpFPXsme8oKgCB89AlC2Cd6YzD91wn2lNcXRNllY3CV5yCfCpPOdWkKahs4XSSDgogKW7Pz2EGgBOXu0djQKLQxpP8ZavrWRSs2QgFPx6S56qfhSLo/Sj8akHbmj1rBTUqZ17xYbf/Ly52tPOvtRtuNypUEs6QPncgk5yck68tSvEm2fpnSg6q1wmjOedxf3uqr++vQ0B8gHnH/eUVLx/fj2K6C+QQNAU+uwGfmaZoY8LtdkNrbWTe3A/c78fgkO+DbjK4+htECa+i+NgVL31MOYUIzdZwB+G1E3YhbM2QYmjHy8sLvv/j7/Hd7/+A/Sdf4enGeOIbQAfA3QoTH/8wmm7jxS0cgdBAG6PpzUzqh/JzNJXjsN/33TrE5DM7b3bbsqhlt12Dc6CMx7OoiFrbQC2FG2I8VVWgbeOBOQ0kMzE4L+recey7GazzJwWGlYc+pZrZ3xqlqCQ2GBXOGKqDRvEqVb4UQzwSuVUV8jrKrGiQXIj/QnQ6oeW1CJot9eL7MPWvFxEi8lCQqMbzvWwc3PFGarw1YytK81lINlMYsmhJWyPm2c3EL1wtHEMigLezQPTKkzrfN8+8Uc20sAztKfxc7VnUcksaSikMZBFJ5s+WmWNcLShtZZOuKnrJ38ePPHoV2WfphApW1qaLkkTzGTldQfUyTuPSfWJKV70Q+VwJc3Uyivdn5k1HHdOYX7VmcxfULCvwj6OHmJvN6knUPH3BIM6rZTh+Lb7OvCLLfBlTHUXxhVhrjJS3sl6lIDezw8FQ09MU715Rad+DMwVqWqUFkc5iugYincJOYs+fXSjWcCfLzSrTC5rCrMaQn8NurwreiLaBDFeqzSWAgGJHl+JxIsK2bZdJnFei73jfXR4KM1Xlk+fsHDizxqPrJUCyRthXy8+YEC05v6L9VNi7hmK7bcuZlxz/Os0aeFO1sqvuS2PS4y4Ps8+26xST35vuHufI+GwcKaZvpPPanxx1wOkgRfn+RKvux8KlrFodSPAe7iNJ7W5RK3jqIVPuS1WnaMg0BwNvCyd9c4vuKO4oRzQzwGP/vUmKYym+C45zXYtVsUhFg8ukPewG1SiZOk0U5p9JMSGWBb33vUXE0D48uLm1gvKjTPAoGhldDAy0+KGLNTIw326xtIvhCERh36mHWRJKJtWKMvrdNAGtoelAh7MtkfKeR/E5UCsZTYgM5NhY9nZOeO2iZpzxlEJVugpEI9P3zG5s01mL9HoevHoB04bbZq2z4QkfP74YODfoibxtRokUQO84ZIdoA8kQh97I2ReCrQ2x6FNr2AXYVPBEHZ9vAHjcE9u2QUE4FLhjQ8cN25vthu254d0T8OtffIXf/NN/gi+/eoLoHaqHuS7cIGCoHoA2K4KNFAWM0Y8KpN8H98xEHI0IkDb8Xk2QtLWnwdcKPk6iBHlhUHCBBnpmIxpHWJmNC2lWX8ohiBjauy261KEXkxylUiq7mRlt2wYCrXRZSMyHMiYFtvPUIeNLEpXi202h8O+Vh0yZxFZTBv+sM8TFX7UQqPxHYr5Ezeni8k4OoTkz9OTWEbXgk2YEu56Kx9X7+sp5oxaDCoGSYMN2yUXPQ6sgjX+GKzn4pce0CZM/SlMiXV5UmhZEVzHwXFJCdQ4SYeYpdfOElgUFpbwXMidn91jtR3lGPB0cUJlcAsgCqFws6cFCMeasRVhxsWDiofKPi/DKf7zwbIknMdhqRTfrEGZh8FUzt3JsTqybMhpWXQumOtyhZV+aOr6M3x3Jbq0o83U8ZxdcPWoW5/3CJpBka5J5QaWtsb6yIa0g+fLdXomu5+ewCLzbRYDIEl3v/vx50bm3LqYi/jpllE7PW4Om8WjixlPD5n9vlfrk30kEqQG32+oIoovLjxTv6RZNydUE8FHkfTbj18j4VdF85VLkjX9NT13DaNbz4nQGVr9/ey0x8VpVNqR/Ncc66/2YtQQFtGlEywRJY02sjV2KzYvFn9YpJRUkXYOHHH/e3q8sjkrj5x4nZxQP4aFlaiBBQUhe+BAhMsS8ovdDSltf7xxz00AzW9gNzBuIzU8ZfVZORwAXX9CkNAroQFKL/iioo85fJkxZHuGIFPoYn8IR2o0z6EYEXWRqihG0pXQYq+FJk1cIeXhNpYGVSUGZkPg/BxDArUx62pJ4XLQIVBgAjvdEyJ6xFPxMagzeWlgX+5+JmPhVdZThI5GTUn3ume0Oq7SgeJ8tvpNOSd0k5WhidKJHuvBzbm5zDY37rIun0w5g4va0gQjY933QytpAXpSAvu/4+PoR/b6DiPF8e8Jtuw0Bat9hA5EA3Zo1TS/7HYLhLiTMoDY84JUInRn3rniRhj+9Cv72d/+A7cc/+gb3HwjYf8Dv//Qe//bf/Xt8ePkDfvnzz/CTrxmfv+l43jqenxRvnwlPbwhtI1A7QCqDVmJf/I3fjC+u70D38XVGtSs4izPjV2nx8hRXOBu/avg3jnGGB610GZynLgP1Hl/WsPtCGYfnpiGsEzbvFJMueLaKUp2t3dbLayoEWI0OQ5OXx+iuJag10b0TF+7qeCNZ1NCEus73THbIZCrwSiMok8eHBbzS2d97bEJDzpjsmebhMLrTnoIRP2Qpx9Q8WfZpHoBG25i41yShTK+Xcf4eLmNvjc5XROy772HjNtIy+cFoeEbFunG11iK+ip2uJgtr0T0uSDkhvT7RqOl1fjA6rSQEh8WtZbxGj2eXiHMpclQnFFut4aXFkx0FjxKSMc7uVJADFN/zRWgpY3owRFgpTp4495TWX+62UpuUyXKsKuAvgPOcj2tqIaiirCk8Hs0hMmzL9V5FrIhGSfGi9FkejgcE1ZZhJFi9iKWg/8M1lcUOJUe/pQh4mUYRYJeY0izkHGNImkMk7M92OtKVg2hy+hHnxi4ORR5njTULCAQhqV5Dg0ahs7iQeEMNpfJApQyHYXukfCGyK9OMaiNHNgmN9EyJvcLN0+V6FDx5hp6t1PQkKjzb2tXzcHqmXhCTdSxytjxcHVxWS7UrMaTv/09ZAK4NpDdnzfjN0g1o4DEYC897anNuQHDoKekPRTxZXJfD0WaIALWE1+jkyJQzowwuiRPbrSrLdFCXAsZ/MEdB3oNi57oXJlqaZMy8e2VDNU2AH+fMEAKLGgBHOYmqOg3nVweTrnf0voPIinHzoKaJ/tnK+tBCyZLUHBTvfdURAQ4lkE0kaKIx8EkfEneGAYYsiVqHnsbvR+HgQJ/F9meXm3FP89yqlvPlkON0z/k5TTRPQHqkKGMGi9z9BIOrTKQlwbSB0UpxbMBLOKbY3tLhiHOlR0vOOIWwfWrytZpI0EkEPmtNi30spfYrQYkZcJodRiWaGgd32Z3K6Gnssd6x73uAALetYWsN+nwzqug2jELoNiytjwPHvQfF56CO1/5qHQkD7Rk3bCA0+Pa67zv2LnjtDe9fGX98UWzt6Q3eC+OP7w+8/uEF//ZvP0D/t9+CVPG8Ae+egW++JPzq2yf89W/e4T/56y/wm199hi+/YBAdUBI0GOJkaVQqhP0utsFbdsJKYaPT9YAT0UYBPy6KETXfRqdFWxSHvsHaRhZ5ylEkRvFc3DOq24Q7F9TisKwRnH241bzIMxJ6HEAyjWjDYmtScM8onU6+2f5ee1GdK9pW4pgjeKFPllCnMe3JIYROjACqJ27Y78xoJU1+qr0gaAVRVIUYMk7M4SihsrgfAJMVGqlEkVFFWgoxy6K66crPEkSxlQfnQLX2fce+79huDU9PT8OmqNqyLXShShl55HXqi6F6a8/j1orqzX1al75c8PP3P4p+QbV9+9QFvk4QVieHtYgV1WBHLu2jB09mMVcuc+bZnm84OdBwENF0EUFxTnDuXSMCbRT8QO05ep3EvM5lJ0xOFZ5amOJgC/cpqZhULAWVAO17ID05mbC1WBraU7lI6QWcuoHcwzodBARlmSxHx97uOZsJpWAbYQq211z4hkITmJ1ieKG9IYqLiNV2kbRzZKWnd3gV5FUOfnBtpRRqnBcpLcV0CXYaFmO08PCPRCerZVqsFoHykcFgceBIFDRa6BrxLPs+JdIlR1nDSWkUC70Uj3oRzrLysaUaabghIE5x42HpKg/3lNik6NNTyLNVjQME6SnvOiIBNckrhoHmBUcIgmQKavE/S/Zs+ERpkjLpkaVg1kzc1ihJJueRwKbtHnAHj3WiNZqlfpoO1SCmFNTyNBGdpp9FuMmNAgCajjGCJb9SEftSuKrkV+TiysMKsg0kz7mXA0Tpk8tPdQ4alJvD8kjOAXPDA9rR9kTI17M/0hzFrXXPU/NMFuagVDya3tbckPGc+yd1YFfZDCH4LO+PJ6FyeU2RTB/lx3eSI+oRTFhNHboUzcz856pD0pWVaZ2k/rkJ/6rzWFN563MQ1/Oozv4yRcjs2sNjH0AuM+PNmzfY9x2dGK/3O/beg5K0kRjDokO7gU63bdgIHrudX56t4hMdjSRhEPDmueGJn3DrjPa8AbJh+90fv8N//Ic/4MPHj+PwbhtURzrbayd8fH/gZe/o947n7Y6f//gG+fYdcDtwUMehOxopbrfN6B4j4ZKwpYrb06jcFQE9Lw4GuAt6GymZ3BncBE1a2CMRBGgN4Bu4WcerDGAzhS+dpDoD6ZNRAJKLCCQukLyHtfjyuoOBXSZ2qPr9dew79v1uanv37l24lYFayCQ0jIAZTR5WFOC92vfNOIePfgYPLNEQNtue6ZLXGTUkWuSORNOYq8uM2CQ3dRY6+Ig9EVeUOPr8HIwlBtjET15EUEEh4iAobfnkjCHpBV4LqeenJzw/P8WFDVGzdyOcTtIyhIoCRhchlhVL7naB+A6drkRnr2yk//bkZWs8ab9X1yRIKg4Qa9ZSHWmuzYSjUsw4NXWJuMuMBHoJsljLcUrckj5Q/X3BxRGk2LP5ZCd8mSmi3sUKAg4vco7Iea7JnYbsMUn6spKkM0b9LFr8eQyNJjIrKp/8SLqKxJ4+kZiqEn9xiim+sXEpqj0jqg2g7e1m0ePiTUk69IwzQjPlw2hovkz9OWrlS5v2pRNZU2FCSN9jxQWDLVGOKAW2WgSnIokuMbFZuVKmMzqNIqLMqfjYx/C9CDsrwpxBGQIJNOnEjVhoEChNnL8mFwFu6EdK4UETul2EeMFNdlZAISksNbYs9JjJTWdyi8HkPELFgcMFqiLZBCTHH9P/8wbAnSGYnE4xB6JoSVB2L2ZH2yjWmztVeb9GZycXE162IoZ2l4/qYqUYYviuR2neuBg0UeJXXvAW+mZjmvRLIVDXM30s3QyaNTBmotBtvXLZe1h0IXbHpKAxG1an4yRoNsR9zgdXbRGuouKodCtnpU60QtFj6EbcTjTJC2OC3trUfJI7rxS9QG0qielhAFQ+VykWfdk880KBzPVYcihQ3cJonrCERm1GinXR4lS//qtiWNSNLKYPEPz9HI0gfboV2LZWpq6U92hNSwVKxIWH7hVAq3RjWp2Epial7OYytavTjZpMmhNdMrrKkgpt4srexyTdm4Db7YYbN9yentCPTEVXoaDXjAZOcXTBvd9x9B1KinZrYSspMkT/I4fBLLJN27CBwCpg7dheX0dUfLspmjJYR6BLQ8cXbwjffA58+6MNv/rZhn/268/w8581EH3Ay+sBbfu4fnhYLpEOpShbBHwiMiOGs8sxxiAWOc/MIBnjGaUcgzIGj5vbDcwtUoiY71BpUBq/CB1CI21omshOsecZUVz92oMCAQnVf+WwcrG5cRU4A9i4jdQovwK7xs8inONlfZF4sZnFMmbUWjTCctULbdDwB17G0ILsuEOo1We3hhqnu0Ci02hPCwrYu0zIPZfNLb2f0hTbyaXAHFzi3BluKeybRxMZjjQ9G8NyS6P9EKVCiwc7TWNTbNtcbC8TDFyI0tbiOdw4JvGdZkAbeLI7mhA7S0wjXZL7iu2h6nxpko+8Kr2iHJB1epCXjZU8kdLWyqgdsxtCuSjd9eHEZ8bM/0+UZolcvuQzlxhlcxTwzoEryltHiZ7kZnzVyl919yJfsGONyUSjmp1ryNQmniWQxVVtjrQ2IdUPuUygOKhWZYLj0dxxcxwxNsyLSiMdSwu/NRX3OdL2Aksp7QJTfGbFAgk8ot0tuNaL2FFA1b0IptL5xy9119oQeISeYQ7FSj6/DCqSFreBghLqWkRM/GJDZKcp22w/KBGIsXBAtXjHFDoSo0asl2KT6vsv1q2T50Qa3c0FfJ3o2WnqgIIJBlfKGFFBiUVnJNnpfoTJ0QjFPjI+JnVo0YSEENMW02ggDbwRvpyYkgM4miK+5A0Wb37CVNBkI5m2T+y2fda0gmCaKn/fhWJJ7ogypsy+dmL9Cgf1YvCS845gbgDdDLxzDrWmcwVqZkEr2QU0QD9QtNDj+buuYqbBBGg2Rk5hlwimSDKmOH/LJNcDrqJI4wn0cMpdun5o3EEEmrI2Nrt/hC6mrfYsxYKHVHSEDjaeRIGVzx2/xNdom6ZD9tBTR5Hj77JZOegcq0j5Spu1iqvFpmepVXDGDSW6L7lHGo2kcb8LROVSn5EFPABhNNPuhQ0zYwoVI9BCX7J7ooCDACZNxgouxtS6hPf4fUjKcUYws+1Vv18JjUZDd4CA7TYYFi5QN/GvbIpbY+xPbSDo+xE0294FbOmzcS3IOKvvh+KHjzu++/gR2/76gicwnvWGhju++Fzwl7/4An/1q6/wlz9/ix9/KfjyneCLzxlPt47Wdqi+YBfFtjXcths21ogdFePZDGswNgFUs0OAcfOLL2ZjfYzueXRSbdvM9/rAfZdUNiuhgYeAjP0S6QMB7cf4gC1t2YILVW32fBQRqYRHoo5kCEosVC7q+8OEFD2QpUohiEJkEoppuLr4qBCLa8cE1BLNaKfO/1A3C3sC2YLahehS/zE2XRTNznoJXarH4j3wJCC84sSs9X6iHsU3XakgYmpIUVEIxXOen9PkWYvVE1gnrrQ8OGhm14hCdXBUgmYEXaqdYLEVXH7blFRZPU6DvqEUh9lJPLugEVrsumqRPMUNG7J1JUobIjg+O40Urv1Us5ekwIr21sOuTgG4IDgrl/FU8JbxuRZnlbqEHB1W8eS38kx1Hjey9uKq4cdtC1QwGopWw6sk1fQ2jYlgHVrA1ULNEtKS6aJZWJZAJS+ouQTEqK8/o6Ux5uekJSiJKe0WtW1zE6mYNChRkJOJyC3MChOy2Y0bX5pXpiFaY5ycmhamUHy/Cp3Ex4mea01CKp7f44JkYKazGKywWrtp8aOmym/31xXjlUfxxdNgsH7fZ3FlCSRrVNA5nig4FROvAMzZ9/zc3KcrzzLdUZwcQ5g54i98mkDQtO0sDQyVYkRJbfIjk0CQwPFdRoExNUJS7rU+QAKlOOPEXEKS2zzzbTUcUHgKK8vnPZDiUYAX60DB5LsNHiCNbhxIZFJGW0mPNM2BmysQFQ1VodSQhsUczCvaCdFMbaRBS0W0ZZpyQDknrWADEFpy7ZcxCpVAubpe1+JwlRLX858uaSMZAnMSAgOTqDZra4XsNbjtHEHvdn8r7eNKD7U2Db0AbMkl7w8D4Lo1+HGnTBeixdJX8fvkM49J4yOri9dJtJvUNKfpnYXyiJ/rz1YrGqk2Fdwo69U+BPmHfc4GAnVAe8dxP7D3A/0oiaDH2FdH7wMQJsLWhrHICGhquNENvI3wHhLFfgheX3Yc+x1NG9493fDNOwb997/5hfLecZOOn3yl+Ou/fIv//J+/xV/+xRO++bLj7fOBbXPVhXGh3DpmUxCbO4YONKQxW9duvKtlhKDmMFLtabv0iAAncz1x/NljpVXsF6UgxfmfvnHdXk4LB1qs43BfWRdcpBenH1o9uvMhOagdqkz+n6C6QJbCmEtsPGaF9YQsEk2joyqHqWO9uR+s7h2ZwqY0v8IjDpWWzTl36jOvUtVdNZIJQzUFFGU0uqJOkglUgVIUz1VoOURtQ6qP5MpFv27EvBDPVmOjiaAQ9kSgRi1a6vVSLbkIk8OEpreaBdaYVZFWC6lZMHvms5X0Pf/8tDoBYPpcc3OGs+BM83uviPrUtE38foXKYUQTzYIgRJt8ClSCjgnE2kCVNPsS6JIHWuXWh2U4Ec5Z4efPFgX14sZyKg5rPH0Nkpo422puPUnhWq0qp89GlSUiBaUtlIQrZx1v7mvKjjclhXsoPp4u7yV+e/1sutA2FueVGdUPKH62JawFMSEEXlfFpH/xOWJPTj8K3SSL/TE2JaaRkiezrmYKULqy8UMfGh9kqMulQK+AEFpxba3hRhrFYepksnjzKdbki66zs8i8Z5PZziWH4DEEsUx1puJUp0IalG4i4WBUX5/CVT0cGib9kehUeIxJTpuaesKM4juVaDhw1XAul1wl1WjUvC2Rcis+NRp9zJ2OYnIV8YlNxnxzJFQSJ6qdjAkGo0Wq8GjkbH215/guRVIb4tHo2XSO/SK2lmr6tW/mKSE77FiOqiGdAAAgAElEQVSL62FPB5Yr0CKG5mWqS5EDsnA8qn4qBNs6BdDoyQJPJrDo6q88Y2nSqqWV4IVbUwT6XPOo9SKQb+XxX/HK13/237vRBu8oaZUeUD5DKom0KqteYnboefR3Ip3C9HI/L1NH8Xj34abSuIH8/ayppvBE3hFD798fHR39vuP+csd933G/H+h7x74feH3dIV1yDKO5sEbmxXCcoTYE7vvHF3z8+BHSBbsQDmF8lBs+dAb9T//yr1RevsPXnyv++W++xt/8i5/iL/+i4cvPX/H8/B5E98GP8iQ6qeIQiYcyPCDHIegXDhs3i7mkvIkMU3Ib3WzbFl2XiGDbNrTWwv+bjVIiOsQQEcTSWvH7xcXAwjo3HIaWUxFZjUPuOPZSBOcN4MrYcE2YukQ9UTem8T/O/tHrwj3xiPUKDV1dNHS2LKFzF6sPr42kbHFxMlmdVWqCoKeF5jiyL5vGi++V9Td7eq+dNwd/rmeHqgvnm/XUta/P7KoougpaD2RAFZ3OQhV2FodQfduD7CEpkmVibOa+Q96OXSAKM+WIT///0e+9GtfFdS46Jaitr//wL0rrq0+JWlZu+voZHiENjwQx6yG9WhbqQ7QSJ2rT+hrVheLRs7u6SK4cLa5+7tVrfcoX/upScqFTdSpYw7TI+eWUEfRXtnWPUKcVvZqFcPQQ4ZrEYoVr3dw1Iizv5iCkuNyhi+sInfi/qw4GCgidBWSP9s/UKIGL84Wcx+fhzsLXk7cHz/BqPV6ti6t1Na0vRQlEkkkszY290yr2hfKA10qhMVldl9INCZMlbnx3aOdn1ymLUNMnqX8vykWEyZGR4DSMLCa5NAke+mJIt1AkUU5e85P/AWdYjE8dlNBdfGjrbmtPUC0o+uKJz3wrUzAubjlIC1bXWYierGOrjXFQivTxHf3ojOqOvl/aV/qenikeoopexNC5x+hhYTxPEj/lSU/nYD1sl69fzz9Hs6/SZB+dN/W9+VpuaOCForgW8tfPlU7vaULvmWcqpup0plzRaa6EnAwAXaNfrJaLk9eGDGqkiOC47zhe73j58AEffvg4rAitue1dceyCfhyQbq463Ialtg5apSjQhbALcN8PHEc3n+8GUcIuipfOuB/ApvuBt03x62/f4r/8F7/EX//V1/j681c0VvTjA/ZuZuyQUYB4+pV2HOKBFWwd7PDXPo4Dx323BELg+c0Nb98+4fnpBt4UREdEaqsMG6xt2wZRvXeLTz2GC0prJZLXkaXxsCg5IydxgYtY3FXDxZF1UzzdNvNa1gj6iTjVwrmtkckrDYAWrsijiySV4/RnL4NLBFyxINR0ojuIeHQtXxT4Lti8KjZ6oXTgUoFcC3TfYKxXBxedxnZzNLQYcvkYKQPhZP83o3TnA6Fa2omh6KHmti+2MZ1oLNIH7cmtLYd9VsbTeyIhLNY3Xo/nZ1Sf+ZV14VqE1u9nDrTQMyrRZeL3n78jDS51qOqRbgQPaTcXh5cuByIz43a7nYq79XJbL6tJlBRpijSt1U8d9MdxnIr7qmj/dNGGP/vfP8WHXJugq9f0Z/PoM/fyeZXPPGq2A7tLhic9aqrWZ/6p5unSCtUK7bNtahFdiY/o+UJMd25r57NntgpbjBvcce7ys3yqUfJp31Q4rQWy1gCk2vjM/nfDg1mxOl+OgR6nVeEngsOumiNM06w20RorYZzZ94BOfNXMhGgnMGFepzg5ZuhCm5lBkFYCfqwBD4ukbAZlmSAyt5hAj4TAUOga1WXkfrj3Noy7PcV2iUuCXXjt07QBmHUDd9zWlmhQOic6XARctQBG1Cp7Cn72yBqJhNDgtPuaSfvG3ovInxBWt+HhI2mfSlPuQWp0Nm9yRSZf/kRdPY1Xi/mCB9TYExKy8K+tfEaaPptFBX4yP8MdZGR1vNEUqK7Be/7nnK9+dWbPa/L6XCcDDEa+KC4LaQdTr8758+R6BpbWu+JRUNujc2O2CJWJT+6TS3Hfb7fr7IJj39H3A3J0MICn223ocA6j5HS1MMgNvI317wnW0vugW3fgfujw9N4F9+PAsR9Q7YNSvd0g3MC8YfvyXcNPv/wC//Jffotf/MUN2/Mf8KH/Efv79+ivgn0nED9DBHg5BB9fO77//sD33x/4+EFwHB0bMd68ueGpDQ7M03ZDv+/Y7y9gPvCjH73FT3/K+OrrDU+fAbcnxs1DXYxH42rvbWuF/jFEoI3Y4kupxLKOU6Rt1e9U0Q9HOk0UZRATc1Uv+0RcEqHqYwO7Krmbgn0krFnhxjOfzckMHqc+jY7twMpDTjCZE2sKtdSlxpJocaSWsY0Vi+OEc9IzYTZHgwwPYliSIW3oJ0CxAdNT8T48uzFzU68QIaNjOPeafNRNZcQuFn4jUqJhx69GHM4yzgUTF53GQZQe3rWIzxCXufh0jji3pIVUQcuwP6ZZICcNjW924SzoyISqD2cArmjQUuBcxYVPlzdnVD3cOaK04eGFuqTMjdAYxLPROtYsdpB+iW+3cYHWg9APpT8b5mR+tY0bsFmErztpJFkPjTcQj+JRukL6HnurWqDV0KlJZEcpV1sL8urHvE4QZlu6wS/2YoGYg+IkIhlYgaLSX+y+UAKogv5iCF73Zot5av6uUhZPF0q54Bi00I0KfUrWAohP/P5HDcparNWLbk3MvLxcle18pMKXtGCwSJdNK0iFTsW2T4AmR5FJU6BTQfYIXVu9t7PQHd7Sop9A5UjLtBJFlzG3DUpqSbhzQIfzon3fEWbq3awN0QvK2MJVr6FcFw0uF9eQmVpUIOPLKcc2FZMpDBX3wMzZo2sy/LNQC8tBGpo3+MDxRm2cicqJTvu9JJgKvVF4b4sw15I3g0DDoMYhSJ2eA6WI2Ome0GOUmguQkM+x57TXG0YQRI7xe7tMDlyhFULRGU22c0iDVT9HK+1BrshGFD7jdAn+uACw27mjoeOaG7lmz7CNNEvvhARTtPqQdLhjVZ5R4txj0BSalJauDCBF4jVBc+O0hKxLVU0/Mt4/TQJiQjFgKFO8oJ52WTQ/NATjNm0h2N0FmzzEhCApbnUfhgsSiruL+PSAY3/w4LOAIybCtDUjBgeQYVnKYoJ7kTSSO8wlq3fIsQ/w7b7juN+x7wf6cSD95e08tkl8Y6AfMu5IdyqK8Czg6IJRgw9N25PVSCMZnC1mftzP2hj0P//rX+nn7Y6/+osv8bOffYU3bxvu+0f84U/f4bvv73j/g+LldcOHj4zvfnjFDx9fcT92tEb4+vmGr99u+Mk3G779ccO3P1L86KuOr94pvvmS8eZZcXtuQBsOJ7TdsLWGzRIqUyxVTfATTe7S48BrjdHabVBZkDQRt3KhGKkcw/5Fao7Y7O/tY3TiclzWAkAEL/cXs5/ZbCTbjPqr09HuXPLh8ThfbgKO4si7yB4ijyJK8s+0RJFH+qQLoIplmHO7cqzGl6OeSocRAbold1ERjwwVb14xjTj4fA5fL3LQyRd2vmgqn1GK8Ge6mtLcIKzJTBlOGkUPirdxtWNyJMwLyyoKYabT6DkSMwMRHs+rtTVQCNFIxcU2JZbyEoAzI7hzGMiSjgoTQy/OEMHPo4U0Ve5zvkyFLIVEUJ/4sqipaKeKmD1Wi+8ueNfMNpLWByhDFiDezHZLwcsDXCZRzIocz+uEpuf7KSR7Hq2eP/OEmFwIWB/RetZiWhdRj0/BOHiq8hAhf4Soc+FdR/8hevm6VzSSFXVaEffV/uyq+VunVlBkU0ILku8hHBef5VMJket/C777gtiyNTNXzeunEK66TubpwMy1btQugYM/R3k6Tzv04aTyH/PXOun6FG1rnaI9osZ4omOln7TpwOAT/1AwazFURrnsosYRmd6SY5zm25MhQN4D435Qty206aDrtMJNvIgnvTivwk0xXU2jZmE1i/C/cFhUz193fkU6CYaryHp2vyg6rOIBXf/9xIrQxekI6blf6VcKKbaJLkiUavRTNA0rFYxP4BZPbiZ0NRo2MAFBsg6wySxe6+tGsicVS0mkF9xkLUxW2IYWiSa7zqH76JC7Wi6EgV88Gi8mNmcbDsA0gD6bmGuEbDnm4xSzoQtk3gzwYBOu+0RkQ2s3NBohNhCF7gf2/oJjf49j/4DeX3AcL2Z/azQc06N16ZDjgBwH+n4fDltiAAm5M1AL8e3r6yteXnb0o1twmq19MdvErpagLNhluPodx5jCiDIEQzuh1qy2bbyftjXQf/OrH+uxH5Z5z3hi4NZ2vHk+8NW7G778/A3evX2Lt0+foaHjtr3i888P/Ogbwj/54oYffdHw+TvGmzc7np92tDY44iQyEn50/PChfG243TZsbQtEeR7tyOxUYcX3KpxyJCp4QOGxjLkgGGaaEck9JQQCaOwK1SoQC1B38s0c1mCF311SsNjQVl3sCgFG+mTAvLob5vCICZ5Z3BfS4J8xj1ed81UFgInAUBltahEIJggV8bDcTAFOlkA6wo1GfG8qlIEj/Hur8M5Fk5PIxblxnHdCbbKGsKfHQbZGWascFiSxIn862QpOwT1ak+pK4V6806s41jtmXFhExeFxoVCvoplAkiKZkovF1cKXxTw5uQruuUIARQVNU+zEU7S0ZHJm+f4dOaeWAVex/my6MSfiWUwuM7RIwLSOeCZtgRZnjPkCnJ4Vkg974gJySd5jXpIwZzR41l4EgXp2Z1FMgsmzeLKCk6VRCg9dvRR0RpqrCbqcqxpN+FVxpWqin7SWY+YiKg3loa01QMto2h0xotGLsbpaI1+FWPJnefxzZHoWhM2io5VocmuazLbL3pjTJz9dyNax81ljkoDBFRd/Gq/bBIeu6FtFxKwrGP6gqXo0vTiPq/GwifnH6Awe0QrX7+BTnPSz3sBR+sXDXFM0Pgn7JQVq2UzCim9EEZ/7qnj5kcWTVxE3VYQyCwrVavfZothJM8Yi8gytGsGHaWToYM5FqeSDeDHERZye52ejtMtUF7jOmHXho7vdpUyi6bQITpFyRWRTWFwRJJ08YqoHeDgrqRhfmGNRqrjzWTVhKJaHEZNVTWHXNckF16ZJ0z4Jif25TNeyxjUaNZFZ6FWgc0y8eJw74Uc/zqnhkd0NN6PIRKhAqEauS8lViHun2eTTMxqKCQW7o10zR7ds5kasezYJWnI+uiWfwrM3zIpy2EFb7Wb0u34fCPf++orjfh+UPLFzmtyNj4MG3Y8h4vT1OL6+LL7340Dvgr1LDKFEgUOAXQmvnfD9y4H3944DDa3dsN020P/wn/5SsX/AN++AX//8S/z651/g268V37wTfP584M2T4s1Tw/ZEIOpo7Y7GdxDvaMzY2s241GIRyIp+dBBLQRzLJjPubWuMbWt5KDSOS0VkPMhuyvoxnpcQt1CjIbp0UUu58MMXMlDKXAwZOZ92WUoo/OOwBDGxaG4BEcmoVn9d9wkNSoQk+pDGHkUNbkgrYR6TXfGX6Fq1PB/Ea4KmUxS4RLhWlH6gIsOD0g62ZnHifIPo4N+PKGpGtdmH3nGStZ4CXyz4x054JStA3GLII9RppGlSjJDmv/p+n8fG1TrMHlgUHrau/Dvxg0J0NJNSPHGrly3cFeUiUbkmBDhSHcERgZzI7GxQKQiY49GzkZJA7mkJU8riZRqWDw5/18mLuQA849AvCHKMQZex5+RqUX5W+IcvkfYnFwrML5lri4pIdWafEtY0xrOXxGSiEAmcZRIw2RHqJBibPNTX51lTrPCAO1jdWrSGqhQXBboucB8JiuL/9wf8coIFP5x5+3WyEEWsiJ2nerlGatLgWgQ2btOkJX13w5xxFFQlNtrfoy4FqgsyH6HJq6j2oYD4As3XC9qN6ryWfCI5UWtaM1cq4+12mRD8T3H46y9vEmqhfSVUvZosXAvoNd7HFT3oU+/taoI5P6OtAAHV95jBxfG8Okx4YqaWgCgsUzIqoTZxjkn6rwdF6yTOT+zd92zjDaAtQAGxKXTNACimrXG+poe1gUJUGgL7M8kkseyA2vzY9JiXqUrlzDPBALHq3FUK00UMmwFTs9mCSKFHXPGnodEMEHhCyWeNWG2O89xkEEi4AIK0OEXN1qbxX7U2BPOUQONsK1NLDOHkAJ3GNFRKknTwtkUt0HCANLfb06AcFtFnlz72oEoaYpo5xra1AbhaANUIqjnic0s/ljN9gFVsCB7DnJZUZtqi6uTQxQaMKhQ4BoB7//iCfd+t3mBsxlWXLjjud7y+vEJ2iWl3Wj9z0UCNYnHQTQa40o8O6UF6HYmrfUwdOhR7B94L4w93xd99v+M//Okj/vZPL/ju9cCLMuh//pvf6Def7/jlTw78s19/hV98+4yvvzzw9ukFt+0+XC6I0LYhfGytgSDo+wtEe3Q8bWMTr2g8pOqry80R7wYuUeKqwy/c47qGGMBTB42DTcN30bk16VzCIE4Eiim9uWFfRGvbdNG76GJSFbNGV+boAHjuPwM5UkeheOLRttZC5OlCCIf4RKvIacNpJy6Xex07dkGINa8u2CuExwvtijCRw9BSF66FJdimIm7DRYY4rMoC4eYWPrFh4ye1sC90D6OxKCcHayDumSa1bR4E0y8uc1k4m+eufx4l5ntwqzlfl3X8WBH0SMhc0Es/tWqwhS6dDLnVY0V012ahjCql2x7iyiE5Z9VXOlUtYBkjTVPEEa1yQFByG2OUutjefUrFfi1zw0lENwVYUX7/Y58PKG3i15efz0ST+4wHd9QQleStX7hlILUA5PwdzL7qSaHSE2L4SJh4shBcorrHv9e4YpxEQldc/9GM8EOXEWibNAwZxZ3tS50UeGok8MABhZLzuqLAn0Jrm1/8K4K7aBqukFi98KW/4umvjizrM/PC/jz9kUDnori/KOgZZ4R/4rQ+cH9Zi++r9fSo8P7HuKY83G8PvqDKdnjswENzcRyNttNN+FTgzc5JOk1zcwqokaA6OZfIfNf03gHeSrPriHibDHGZ0n2mSkLr64uHliCne8FT9jtYi5NKfA8Z0KIm+lOrLt1VbRTvA+QT11Q4OFhoNuR3I3JKGVNl60C9+BvFYJo1uB5APrHHNL1//+x+XL9raysnXnlNgA5L3kVjQUKn9brek7BJelx/pk8DMJId9x37fliojebUrugTVIHeR9hf793s9+zlldBuDU+3p6DtkrngHYdgP4YLyL7vVqgP5kCL74MyoXW+/U+p2hNxQNO2WHQov/UY1JF9P7AxYzNqZZeOvvf4HhvaJBR1Z6H8/ENjNyglg1I00jx5cjEabAeCyHD6OZRwKOPDrni/A394Bf7hY8fff79j++YzxbuN8MX2OVpnI/oLFB2ix0C3tyds3Mai2zuIdtwYUNpsEjPMyoV85CKBPI9i2r5oGhvttjFuN0yHK8ydQfo9RjLbtuG22c9lHhyabgi0jmIch+ZCdEGm+4dfXYqEWV1rHZKr1MNHk4ZXeS0ioqCZ/JRGcbzvOwaAz3bIJGzIhdKiF5w9WsSNo0Gg2MBUx3uCUkDq5UHrhfZ8SdqC6hLjdPbwDENxpR/mMkHFh2fwsIjb8vruWEJnj2vfNFJtphAH/BT0URl0gcy1CwcQNq/VtD3z9xIbFgTvtZLHTGGFVFFdLuQKXdXchZpw4p1WaNPXtAt8zzezIfut8H37KT6eKH1xnbdeUWi1ptMDW0BtQpGJV1TXyjjpgSwFz7cUjbRInCrVSQu87c1Z8jVzkjRen8FbK1QJTTTedQGF/1sbGufyt2XEm2mJpVEKqpPExeYIhppuKApAvWoldPJzTyvgjGanAsev/M/KZa6BFFfONVeNclz8jTOIi1OUDVoCeJz2EhSuEgxTmwWuazdRylmfcvbPFa3OEFTEaGdXnGpLeNWIXPGdqx0fCh82w8KaJdpn49EPKYhYTin951RqyElQ6u+p0TKlmwVqa3O2GYCSMuYaWGOPuLV8P4LZxbkglpO2yKV9ikykRdFB0LwXEouZlX0n1wctQjs1/2lVo+tl9DhbGnKlaDn1iTzLwfZED4Fr3TMUmR5qAjgZqvVAmU1sZRzy0ZEfa6CR8pzSWV7fT/apARROpF6BLmraKQRCy62NFGyzPvSRqE8le+/Ydxc/ygjUc4ojMzo1UKdA1yN52RqEWny5406wR0r6KlfOdAnXCxDn0kYYk3ZJrbGMc8PdwLQ6EukCpCDpe1p47dptAp7UiEp9rGs7QqoIkGPHfh9o93HsttdueNpa0FCOboX5ccdxdItNHOts48FjZm7gNmgjTCNp9+PLx2AxVM3Q26fB7Xb3MKp6vEXH0r2GNHtWRmYs7Pe7OewduN/vkKMPALj3TBnugsO51tZUitFnugg2tJiY3LZbsAd6d9MCjV9Ocx3g77AaJAztQhfFLsBhzjebKJ7Q8cQHPntivG2MN43AAmw7nvC79+/x/cv3+N37Z/z2h8/w028IX33e8NXnz3j3Wcfb51fgZqNPVnSGVf3I8Y2h3r4oZpQj428BRW8N3NQsd9riJFBssKQPnnhrQGP0Duwi04EWjgoookXQNPZeL8LVxiwurur1zDmSljLmTFTEDrmW3EUyPlD0wxWhnzr4xZPampXNyPgVCZS1lZ44wo+xS0c2uo2QiHjYGxXqgo/4xW8lU8X7mMk/3+CBO6poqaKUgrfs/Bhb26L5EDkuuYwiNOG9oHlUVtO28rLFzJMj2PSB4nCOsp8S+c/CJsuvSIPzC5HLdxNhFRz8sglFU+dYNM+rDaFR5auWEjgvcnN/IdViLTYj7Jn2WTi9xACzbXJC5D/QGMUp6ISuaEli5LL+K2o0TStiTZ3Faroin4FC2DNrGH7BtkbFC8dowkoRw6nfoEpFmeygxtoJgctydwklyiLlYpJi8bcWxeRe8ovd4SSYjaJV0i0H1wj6IweS+NX3aerkDb0COPqRlzVnaqzKfIGnvsTeR6V2lLWt/WxTGEl9Qc7XM7rbrmy7zlkJKzr9UAi7CCcnNxihWbZRvtd+9As/ehOVqUwIuf99Cpmi2U3mof8+ARu3Ez2AvZ9vVPIG7I4jLQABYzUlIfVIVAoYUa3YdCDHNQNa8gxGM7PSodbwodRwjMKlRzFGJeQGQSkw/m5XCA4cF5Sejk9YKK70nCLxFMEEBsGKYk9SdavG82TBm1WxxOs2gk8KrXLUCple6p9XzI8b7WbplTe09oTWNivabgC9sTE15/kObzoEQAerQKnj2F9x7C/o9z2ctIaWY6GfqJzOv95N9rQK8N1cgUrDWf2BfTIwhcXY6WJLoPlJabqyLjI1iSv1EpVDXydQOqwM1wC27AUkQohIZq/60cEdYBY8P23+RZiT1fj70YdtnvSMuJfq2PNqYYzL3ue2obUNt9s2Tbgu9RSq5jhSmnunkpDG5+M4L4fjFUSghzmcuA7L1l3ewwI5zGCmJ4256dDhydHtMyWfX1XRtZzNTnsyBgEE5uPeQdQhSuiq2OXAfu9gKG7thtvtGY2fcNwBfj2GO9h/+5ufaN/30bkQ4XkDnvTAZzfBT7/a8O2PGn7x7YZvf0z45gvF198A7z4jtNbRWGbxmx0Oq5o9Lax8jC6DLlJGkTVYZx0Zp+n6GVXxMcGVy8M4bHqxzMInxTMzpyqL7NiENRrYUT7/rDbuGmIruzSgRQE9Dl/xxRRjruQGjsInnRZG0hfFGGRuIuQTRQHHoUeLePNyXBoH5sVm8IAFbZkSChewSklFzESzhIX4xGtOa/ZC84FOqXkVmdXKETxtVJ7mtqyEjkoZccpM0m68GfJneE1jyZQzojk+lOx9dpYllbByAgWr3zl7Apqm7ZGj9lii12Ge7BR8PQnEag0keOiiYFOoGvM9I7GL2rMwcFbax8M9M9lZ0gV3vdhSqUBXGwaLmyNcFUvXXGsC4cBRqC9zmhwXcenKP6dP8G0fCeZU/zEkDpy5uXolVLXLlrewqgLnGHXs+3ZpUXcdBMN213HhLScHXkTS4o/koQPK6gf8SDD4yKLyMqxEl4mK8ief24p2pfC2T+Pgem6s7ifTOjdh7ClA5KJRber0wFnDQgktjktZZBKq1b3tBQLHFMJcnr3h7TIlkl4Fgvn76j7CXnUbIaxGnhslC8KTlWtyctUEfEpsWp/nNZ3R7hDOSRLzNrnBdBXj7q52qy3oG+664c3NcYwpB7pEHdGdPmD0re3pGaBm+rLNpcJAe4LS07A/ZMZITMsgngiH0+Gb3fsOPQ4c+8dxNtrdvW0OLlVhJp3E3KK4FB2LCeOvJl4RSBh/zgCW4rtPhQukfbxX5jbEjOw8bo0AoQQOtIQIG01IZq1OpVpqz+mtTw6dpjXi0o/JxYtAsW6jmUdpdq2J8nNrOLz5z8+QRKUi2DSRojfRt9vttPb85wVIIQbUmvc8bGpz3He8vr5E0dyoDapRV3x8+Yj76x2vrzv63kGNTFg6Jle9C5q9ZnPAqatZ58rCDCu03WjeOWqqQPS5jUmN3Wp2WJhAk/F6MP70qviP7w/87fd30H/363+i+75jaxu4je61e8xmJ7Te8cyv+PG7Hf/qn73Dv/mvvsZvfkn48t0HC8xBqIU1zOEXsVbxSmVmbK1Y05wO9ccokxf27mFcEdIqmqlCl64dTOaOEsI8CucIH22tHq7qXtBYO0kKz0oqMboeJewcX53U4cV+kAeax8WBpKIZIjq7aFC6msxjO11SNk0lzVURvqIoDy6/lEtaFHbxSg3FRilKg49V7IuqnVIcYjSNlAe/PDctJhQybRSZatc7FrlgHunnqDCLwGZ0FY8yHoQaKhSSiooDNe/8zKEfdVEVxoZJFKk1LLO7i564oHTiR9JkszpHEK/flKe2jU8hU8Kgf7mjs0cp6PN2jyCr6c3ppJCP09utCKhSwTAjL7S4BxRRUmD9XK20MK1TaKWWmI0oeu4ln8ZQLiRaPJ6J2bQmBTkzFHF91pPLga9urROt4cfqfuuBOpfqSFAdfnLS58VvouPIqOOiuIyixaPFzd2F/Yiq0hIAACAASURBVPBGdaqh4pazagPWQkgn5DSmil0m0WYzWgvTwqCsjiDRIC1d2IWoNLzoJzUXwpkAhXJUKTqkdClMrCDKWYgpWFm1s+0nnylBFrJDxZwiABvff1bcsfniN9fmSGYduObFx87pFqNFWJ9n7Ehq3CbxVxXFf0pvcU7o06kISUpUukkMuqPGfTv0TFUPldO/WEu+9Uv8ty7nwaDVDNeGBCZQkqZ7TJeY+EQ3DPqUTn5J83nt90rRhZNdWIdpu4DhiUy8hXB+vGlOLjqFln9K/6RCXfA4+shJMHcN6RlIt7Xb0IZRG7uSOUWkKNRG15RI8r59r8jkV43JOa1xTlRSVDp7Sq2TuI0SxJJA4mUJGEuaogsqSYoGq3y1Pn2Y9BO2Fw7jL2sln+lwB8lJ8Tjbt1JHMW3TPhSREbwoElOqnNKVe17Ge47im+aaRW0CcPTkZMNCkMSbcCuuugj21/twJDkkAnQiDKnrSKOsQnPe5ntMfHroDU1lK9gkxc/dcATiOCcCKdcNRxcc2nGYGBXUcAjjtTN+eBX8x+8+4u/fv+K7rti2xmi0mV2eGro8AkxupHizKb7+7Bm/+Mnn+Itfv8VXXz/h+TOAbjcQ72Hp4Uhw9U0eRHaJAIwIrzArQE9dm8M/9AGnT8LO5+ogXot4/+fNUrXQFZ16jC1GEAYHeuTISsJ/mkiwF5HKpt4uFoGSlAQguaAEAm3bhNb3LpDOEOogKnGqzS+xFodVjnW0oLWV662FAjOj9yKzy8ba1Dzy7R0e6s47nIWQPEhkk9o7qC86W0F62RLLvXTOxM140GpJqXZYKEcKKRVkiS54jxWVICL0SZHsvF4TWXJBPqspvwzLqchm47UTydH/5P+oc7G0otuzOOp69H1ZcHO1D9OZM0jDn52WcJhhJ2iUCqnJYEirqKqir+9Zc42lzSZDaEXmqDJhiwsmZRIpgEaJ2iUq3eO150KCQOhgHsW19B7cxxBOjrZpjGSnRsCGyp2y6RedKEdzPVA0HMioYXZhsI1gB72q+oink8TJ8SYsCnsIrIlp6q6UsEyTUpQ2LiYr80sU/dmdoQpQ+ZNFW/VXP3GFr5q62LcuKrv2657fjxSm7ppea0UAklqRuosGBp3Q7VngpNM/j4ngzBH3S90vdueh16J+Yx72Y0QBtotI3D9hCcojvI3LPiVLVHZ0buynFq5Z+ayPWQRsU78uHfuxT9ODK+cSd8zixTmkuo7MZx7HPtNViIvZ3z/desy+UiXM2oLnW+80Nma6JkqvhrxT29LGTy18hEpBzYUWJGIuZGYLSDLpgdQ420696UH3Gu+/WXhP42auG46cDoFcq8+J85BSqv7bXuj3sOZMKpdNqXkURNRuZSLlBeY+QJ6eRTfZhOE41Gz1qDiLOHBHmSsQATH+VhWypCFnc4DpvkedNEAn+ulsT0yLiUQJJ7P00CFDkinvwAtcsRAan+aMtX4GO2Wiidl6ZoaE1mHesymkzTToMcXlbLJM7BrTot4hHP4ug3ZzHGNvVxBXFLJ3HPsxON57R+8HuokeRxJ0uncFcKDNvieJ7BfQmCyoJVMeXYy26pqczYSU7rJUGgilMAuIcEBo6BH3PtbEAcJdCC+H4sP9wB/e7/jD+4947Yq3X32Bb79+h63LgXdbx8++esLPf/IOP/7xW7y5dTR6BcsrNhx43oDP3jR88cWO1g+8fBgt5/OTgljiAMM6EgPA6TOYSYu0TXzKeUwjE0dtDSq4GpvxJFabOdPnzZ+oUO99dLOEU5SrGD+VjdPdjBJyvuTmjZDIsKAf+wlhVgu70eDyCdrmPKbhBtNi9LyOih3ZwsXPPz+Tq3jYq3H6OXb6fGlIpVJUCowIXB86j91wsm6rPL/4PXRxMWG2UquiwETcuMqCrCDoYW3l/qMyUWloUrIrFYmVrMK00VmozK4qaTNVHWVSwV9qvlMhnpQUnZTjCEqKTraNwT0MdPj8V+MWxSsb71ksSAd2watdmM7bvULiwr4NZ5Hhuj6q20ImQ+pCUdFAICicA8jGxn4JH5f0j3BLsqnUQMAMGTm6jZLPlBh3Mzr5UrsOg+d48djzhJKU6WLL8bw35RRgLvQpokJnQtnTZU2N4r0K/miiNfjnWmkalTpXrURpQXPr369sAGf7vGVNMk/rYqWQzAU0gWgLWsW6duLs8KkhYNzcTLutBZLT7VprAVhs2zZbXQaFlB5EruulPWA0QGUq6PcNN7bEaTGrtVlQH64KPHyuxzk6o8AaEyUpAYpnSlNtMup35ZqaA0eAEiuSj8UfP4XYfl7UqUfSBn0tOVKnFt8+vLIr79eT+Urkurk6kOlZnFnYVUZScZz7fqb1iZNPQuiUwImoj/BN7N3apH+KZFpzyMjnZdoYv1Pse6BlEj3EyIytzhHV3UIcdqYScsXJgKLC33WP76EAKMF8427Lz7tNzl5OSYo7URMl9SkgGwiBSoY0sd/YK4vdqdVIUmhIvAReuTGEFgGjT3OIaGjXaFA/qO7hxqG9EEfSuwA3p+qYzzbGd37sB3ofhauf4wQM0aJNmmuzrKqBfNecBbHk661tuG0mlRRF18PANwNwkfqY27aFwYJaQQsR9F0hh4n88TT2uoyG2IMCG7sX93jO6swjP6cp3UpG98ZWULtdMQfPX8Pl2qigyCRYslpj74qugvsuONCwg/FRCN+/Hvj9+1f86cMd372/A0T46svP8NWXz/j6CwL9L//qC/2b/+wr/Bd/9Q4/+foNtkYgOvDy8T36fuDY79YVCBp3bLeOt59t+OKLJ7x9x9ieFJulVXKgXGLqZAGBB49GBBvf7ODo03izphfWxZSRxzJxSTNiXJfCXCeLvZjFa+0SUxTa+7AncvpJVaC3Zr6XTDHu1yKkA2ZRCsgiuSMiNT2Os4huRrko3W5FQ60brO4DOhW1xpMzCIEXkcr6PCpqBdJYnCjd+ZWf7QVYbol8LqrNsdY6Bp8dUHi6cIbf5wYUFExCYIMz1WFChBGx81pt+RRQGhG2zQ++KZFTISUU5uRGwp8YBxtCEEEw/s365UcMvnjZ/B70dGHUEou0ihllGvtNwUKfGFFPMeRW+JDTlRZu6OR4QTlKrogMFVFYptAhkN9L6zQnaEyhL1qoE0jBoY32et/LhKOuRaeD2HOS0nyZkwHZa1dbxwk98kvOm3JPTu17QR6rfdYaaJKNQ1Xfr9QWVZpEZWLJtVvb3IJmiPkMuVFZeLxEsffFboUWwl2nz7l2o+4rmugFDjS41qSioWm1qlPTcUXTmcR3S9pnbXBWYW989gjT6pOtWU6jyt6oxUQ5Q4qBy7gXSadmn64odK4PCfoXn118SiKgQoJ3OuzqbKTOxelHZhaON93jLuqBivIq9nRYwPd0UJx6jO8jkdB5MEEpIfNfNv6zzIm4bqc3Ta8MzKGSQ+ATqBRqYrZwE+dELqARMl9JR8+KQ3oUj9zIwCFflz0pkihe/dKntSTl7iYnA1aXHMWEvGZ2hX/I4bixmMLkOmY2g4biZe2oud8F6kWkWQtP04ycALlvddxt4awxCn2iNjXeFfHO8KEyiachcm2tWWqlQLsVvYFYI2okMbByY68pFuMArYJMKSJZm+RoJhfXFMvhVnJEInSEf1n8u69Vaz3DtDRogsIZ1tTGxEhoZLpEMW/Icu+HWRYOdP32/Iyn27OZWNA47LQEtaE0sEqRYh5c9N7RD2C/77jf70P0KShGBk5dyklS70ZBOTQc8txSkcOuM21Nja03QnYGpwt7F3QZSeXbtg3KTVDXRv24Cw3VEt9wCPD+rvjdhzv+7k8v+O13d9ylgzfGj758g2+/+Rzf/uQLvPt8g2AH/a//47f6X//NT/HLnxGengQiI/3n/vqK/X6HdsXWbnj75obbEwO4Y2uC5zeMpyfCbWO0zXy+gu8lg7elmYA4DiUr0hsXjticZDgUyGekpl6KyfkbS8UTl1JwRNNhnkKHZSpNOf65ThzMFE1V4CjiUBcYxGHANjjRWS0u6u85g2AC/bAvsj3fYuTmE4JuiXcDLSjPoKRqzoEAiqv6EqsLYA2FKXze6hct1W6PVkEenVFglQeBENXmi8yuC+E2Q4MQZxOQcXF4mMcVR1JEl0kDFdU/gdUOw1rw2QGqD9yPr37OGpZRJx1UnHWu7OZqwfJoWnMSh/0j/YMf/d4aKpJrS2MfXT3PhxxU1dMieiS0m5dZvxBJyoxGTpaao4hmwonn69aEhJlK1i35FF3AbUbkK43tKvBkPCc9iY7XZ3vVwD7yciZqD8N2uiHn8bGLmwuppeEyheBSvIKRa73LWhhXgSXAUzEegj+q7jXnjqmum8n1aQl7eTQ503D6cNcVz0I4rkWoV6mbosaznadiJJYN3Lg4v2TKqJ+zzmkvJvDlM9PCs4FRCI6YINaAJ+19Fo+ppOuGFCcka5TEqnkPvEnNA6Yk0hk193usT+FQwQc2kIICoMDk6oIrZ2nVyUAVU0r0KBIGtUBTU6QDQJBSrDaubh8CbQgN0NBbGbhi5gdMfg+WabNw0SL4dycBgwzUvZf3LDaF1sl+9yzSpWkq6I1Q88kUpSYn98ho1nN6wMH9BtdcgGr36DSjlhZ+hoI1bcWGlXIabA0wSM1qb7PawWgrzKb57EVUeT5XuhYLU/u90juOQ2IKOiblLaY4kXhsRaNTY1NrszbZWVt150VrgpHVbWjQBG2tMEe9FPQx0HAq0m4JkAmWEXhy74lJqYzDTiHZjOpq35l76Dh27K879qOnDWn3Ka2Dvs0CtnwPZTEvvVCcwJitkbOpOXbbe9xMlzbc1AQKseCcrZHRn2Q4GrUbsL3FvRP++PHA//27F/z7336H7z+84ukzxhdfvsWPf/wOP/36M3z2RNjvd/zD77/Hf/jt/0/Yu+5IkiRZekdE1czdIyIjM+veUz3TM5ydwe7sgiR2B+ArEOAbECBAvgMfhQ/CdyEwwC53ure7q2uqsvIeF3c3UxXhDxFRVfOIHjZQaHRXZEaEuZmaXM75zgM+PQL0f/+f/4P+1fcZ14cH5GQv0Fqsc9ECiNgFTiDMOwInQWIBs3R9qBfciuI/JDeaSccRdtlJDXmKcxcj3cpeKKXp+lIUnjQmGurT6GOfUI43m90ItFmVP1c4PEUd6p/Vkhd5flLEnJDyZLlJzySnBa6GPDY1eSpnSASKR5dGGlTKuaV/tiL+Gd32aDDtpge9MGeNxiwvbnhrkuncT/qz6LSn0p7nHJt0MWUbIf/dgDlq4Itad5zTjJRSi+Surhee5/mCgkJPClLAI2ljZXiJHLucgj1T6P5rKXyjDIpaSAG3WPJ/rbjui4Ou6RvDLWLCMpoZN4XKYIS6DFggPHXXj/e74LKxTf//hfQwpfxz0pRLnbFtNeKZxoCakoukuC3NxIpv3azYY2JO+gzKD/7v2/ejwai8RdVdPveAbhBiT6RO9LQg/XONTmiVYzq3eTYimdJlUTT82jQI/zUKTq+VKjoqbOsr2Jpeu55+0HNiK2VKzs4dp4jPGa4DCTp6bUYj11gsPg990eElH5hnK743Ra326S7oGdqGPE1+TOjbxr5W9wyEYQDTdb59wjv+XbVWlNLNUg39iDQMLi63TLohI43/PT4nEi94lWefk+e3kKMxbzAFPtMQilxOkdWmh6AncptI42sYuCHvoW2BgqVeFVrsfrPQkMFEOmwy1loRtW1ygxwnepLcSeCO/yVxugoPaarWCAVFopEj4rlgF32QNJlfFEsKtCambaLdzyyqqEtFKbXh6YKwkbxpC8NsZ2UPckU3qeoQA8+cvKbhTYBKyC4aMSekTH6ugtLmzBn1+PDPpQbZBUAa3qNrQCNiU8+2AeN2rukg58WTFOJNQ630Z9EKG+b3kGMhgwTN5oipbdS2WSIXKcLSG8dodqJ5YE/BHGsrqdVpI/RsAjD5Niim8zbxNgNuLdK43JdnFLQX61I7zIPZZDbrurbzeou4VJS1brT0NiSMDazBR+C0nggBEmJQusLDCvz04RF/fPMRP757xLkoponw9Tc3+PbLl7jdMV4dGNeHhN0uYRXCm4eKf/rTPf6fHz6C/q//9e/1N7+a8PWXJ7x6CaS8IkkFKlAWAklCZgLxGcrFOklMAGZkWsBcbPUWqMCYyXNA3D1uNLpC7wR7gVTdiGiFf8rZVi18UXBALVxDfYWTXKcT0bk6wOZdG60q7b/7ar6fdDllpJx7BywyaJdHB0dQWthlD8Nqw1c/AeeH9oh3Y5+6GrnWYbo+sn9NW9joH80Uws1FbYcT+YtoO31t+joZi4vtCp4dxK/O5x4NP3aYSXuZBMeWKa7noPNltHS+MP+0wwcDUpj+9WlpAOrHA0Cf2PEvNKX0FAvXXgCu/YvP4BL5tP1z26mAomzNiPoMYo7oyRZBaVuQUQvUuIhmvzgKt95NfTbxrjVSbhIJ7MpIYh7pGzI4wjdyFF3NjOhNHQUnnQYO9MUB2DzetCW/jFuWFn1eI9CBQC1Brk/w0EJFno/gtm2ZbOKao4DnIRq9f729QBNti75t47MlcWgLqniqT35umzD++zh78EzxOCySLL00pBQuoxAaNz88yE3sfEDQhNoauVNViHmjTQ9tOOGC7RsPbDCWB5vyqM3VRlAaCRROHopp4Pj1XqjKkJnZZWRqOtXYFQuesNIz8dPnT9nZ80+TMUmfatbb3CyIC1ALa9Ee/GX/uqAU26KEd0bEJqnrakEb8EfDrgN1mkFDo14QXpzk0QxXw5Bloz8PehJ3s3WVnvYangu6eMbtjM+ufa9D2u5WQqnPND9jAFsUktSc72ha11YQqW1kGZ3YYdIFNwxXHUKd+MJXU4etaNeLa4us7++BeP/I1lUwGDyxJcbAgkqCfoWWkaE9m2A4V9m3HJHQFtNHEp+2xobdpRsSet+W3kmbqHVL4r4IVaMhbGezTYxnbUsUM2MptWZjlP+hGSE9CVh0SwvTPlC0OmL73gyCCYbmY9vYjab+LvfsYAZspYPxWdVquRiDljzSNOkZDqaGFXJ4b4SEVpSGZ0S2tVUO4+14rsYwgrrERsbi3ZoUKdJSM60It/ow/r/WMLthuso2WGpsEmT4+0ngzXixzRMnG/4mu68yJ2i2G2QtkRrMqMpQmrBUxqeHE959PuLn9/f4dKzQxMj7K+ynhNe54nZHuL2acLMj7CZgmhRIjFUz7mvGmyPwx/cL/tubB9D/8utbfX11wn/8ty/xj//pe3zzDWOe7kH1jOPdCfWoSMhI7AmUPoavAuRcMO0V8zxjN8+mHwqHeV19MlOayL2lr3l3ajeVNmJBW5dvEGV9OsFe2aVs2mEKbV+89/zAMsPWVtAmIu1gVDw1IQZHmb3wh8ZkyQ6ulDsPsnqnnIhBKV3IVsYpiRk3xzS7xLmbqKLKKV2vi+aY9lsoEdI0IWVzntcqrSjjixjv8ebvelAxfFO8hHgoKgadvmnfjeUd+MNuMutr24DVbxcQncAC6mb0S5hSaimZaZhG04U8aDuFap0qjyYzGsJxBpMUkvN29VmZxUhiiIMkutyYDDA9DeGAS2I2k1/mVjh2npO2qckYtqD0tPB+juhzOVF+MkEbCwRFY4GP1MAwwZZqCbUjR/9p+EI/VFvnNBSeRF2+YE0vb+qUrie1NFgdTIYYiBitrOABxefmxHDr9iTDbrGXi+AYuGkyGsInfgWykVh/afGT4nzELl5OJy+Ncgp1NZ02tjMPE9A0BEwFr7iJG0bUFvhJwdmVX9umZKPpHQgBQ2jekzVySxvVTV5se6FtJ7lPnwuOjoe6wYko2Xk0nG0g19Zi0M+Kuk+lXxfWp823lJDSlY3um1SH58iLlqaHpW06JumAI8Nmuq2NOuUNjw6UFlEP4rJpMzsmLaZtGzZ505VfNEA0yiDIee2DpIfG1FbaFFgdweeGtZS3BRINxfzQ0HXJw3g+jQcJbdB3sWduf1a69IQuiyrtiL921rDrm92f0XBt+gyOcNCk00VOQSuQaPiZAu0JbLY6MXgh/9yUcNGI9ORQxcU7KdCDntcQMh1y78+TsCJtbiyjZ3jTx2Ps/aDDxmDG9TV5E1Nfzma2DO7IOnHqyIC0bRkf0A0BqmmeiZ4gCDuznLdptKHYEAt5sUI2JCTSmj4Zf+agy3AHHiSwz7toyFOhJ0FsG5wjuTKmEXhiat7ltd1C1wdfKu7xkF5whxem/S5lKLpDC1+1BRBFwiQ3ylQaAv/GyXnXcreawTeSHJ4NtuCnwFYKBBUFlRTKBxxrwtvPK958OOL95yOWpSLnjMNMeHlgvLzKeHGY8OKQcTUrEplKJML/zlVxkowPR8XPj4LfvTviv/1yxE/3BfnrLyd8+4LxzVd77HKFLiukLiAVZE3gnFALsBRBlRVVFtSyohZLidqdZhwOQNkBc56Qp5BKpHbhay1YS6RKTQDbpKIFFDRHf+io9Fmdl/qFq0WxYm3rd060MSzKoOVJ3lVze9tZp1lL8a/Zothyzl6ocEsOq5ZVDyT1hK7cDRsyYAE9rlektt+dUwLlhClPfmCwH/iuTy4KRmrNh/gkPbR2WSd7eIq0bjoYo7UKnMhqsouUhqk7uh4UjJQnLwTHQ1ifaMNjEtOwPH7iJzKNWaLkBVDnj8YLtbv6R/15L6BSilWx9NjjjUwEGy7tZjLoTVfLhiGCFLdSErkBRJrciDZudh3SHnlTvIQJIwpbHfi0pBuA1QWRwFPVdDADckf4MbiP72RAc2HguYehkwaaQotRjwTJHgxyGR+eItRjMJ3BDxEiBYWetiHteIPca2OZYXVvVINtrLs1jb710e3kXn2KRdLnpO3reWRF92szShZoMDz3F6IVDbWWrZk0iu64jsAzmmzZTPI2IaLaCye6WL22ZnGcKvn1hQIJOsiH7HNZnWZERJimacBDavN79HuJ2mKCR2RZ4/72VNDaXmbStnoR6BWTHR0n88NWR4fvT8ML1CgGG/h0Y5g7B6SzwX0yL+NGys8c8SECY0w3pguU4TPSHoIFWuTJmpaxKYqADx+QlFJ8RU3Iee65Cm0NX1uyYhA+xgTtzNmbYyceQXvAletim2ayBXjF+6U/m3oxPXWhuRuz2NC10XREhHozKMPPZOrJmP5ZSNGGPwwSzDZiftxs9S0VUw8o0Vb8okkyMCBpx2uLkQM9MPVjUt7eO4slY4b50xqrBL2AjY7Pch+YccPHMWmT2fXNCpCDXiFDwU79WhtiVJ/4BPoUXzfyKru+04AVl0a1SESboYgMhlX27WqiQQAnPQtAosnm/lwghnubzVdvqMg31D0QkJvfrW+lx6ZDYiI1bK+ly8lGCYv7H6Io5jbEskEgecDcqPUOAUJKyfCbzZw/5C5E6vLQQqmjAS0bhRudSZp8BxvpWzcR9zwPrbGh6fLfkf6EMIyG1KThDk3jvqwme7biXppagGEsfamCIhVrjc2wS0p8yNEi4ZWgfq0y7PPOiZqhtFLGioSlGBLwdC54OC/4tAKfFuD+9AmPp4LTWiGVME+MXZ4xzYRdFsxJcL0DXt8QXl4zMhcnyJj3QZCwrBl354R/+bzgd+9O+O3bI/7lc8F9JdD//j9+rf/hbw/4939LeH1NmFFwvUvIJNBaoR6XKW2yZrHvkGovee4fGrEiZQOn58SuWzajVEuyggKpd8LR8QXPNcyMwdcdV65d96Q9BcwROvZy6vHv0XAn4qadG7GFqjRM3mmgBPR1nhW42swMnLhpEI1cYtPPWuQJdrA9oC6RGbtqeCEbN2TmGdO0axp1HRjPSk/1lk2aMriBG4tbtYf7RHMTkqDE/fs+WdmjfUbqqDqTKgxucE4D0cbh/IGq4sByDSmSFKD+IXgjCpMW1GCSJQr2q3fx7SCJjYUnaRp2LtzteuGkjymzPjHr9YhKahOINvVtpAovapmRUxoQc7o5RGLO3nTc7foMZJEBqqyhD2V9ho6yNfr2IdOIR5RNeE6sVnVjdtWmU4u1bADpm5GZgr+7nbzYejkKOxm0xboJnomDfmysmpl68B88a1K81LS7Jh1jupuTEkSrEQG8aIqvbkSfNHoVBrOUPy+bdFPtGzEecZOtSO+FzlPuubZzoJVE/FRTSQOhqMlWmDYvn5EQRD6NCvS0qkCLtOJiDPKKpryh1TB4BYZ7J+goNjS48C5o+00GbvvWd4CBqBQkD8Mm9uCWvsahDZkqpnKb5qrhZaUVydHQElPbbNiLsrpPX5psKV44KQ8FcZM9MXizWhbUMupsc9MU29/vybREXhior9MHwxoiwMnDOjxxuAc/XWq+e3NlEoHkf4aeICG7XGbYkGLErNJmCMSgjTxuTPbcaP19cxca5zEFsSUEYyt5aMazAW1pDcbF9oIZLDo0SU9xts96QETBiVty4TiQia3E+M6J+7YXq7JhgG/wjL59a2dz097rE7PxZjodsqOQr0TzOcAZLIjFhmvERglq/qTahxFjKnHo8RuTnvpwZgMsGN5tIzq3+afc41RLdfylIiE1EghFknYQwiJ0pkcgm0RDB4oJ04UEE4OOWwbUsZ83NPAXceEVGXMaQmIkRqSyd3EkhJLLW3XjzVKt/WwTONrPpUcSxb36pFpQV9vc6hDrvj2D7PrVkDoN5BQQuq+D2MhHvpJVBYoyHgtwvxA+nwTvHgo+PSw4natLTQScrNDezxP2c8LVLuFqx9jPbEMYFZQiWItp2FNOmHLCPFUkNi9N0YT7M/DT3YKfP1f8/t0JPz2s+HRWnEGoRKD/+W9u9R/+6oD/+G+u8Bdf7bDngplXZFpAKE4yIfCUMKWMTOaKZu8CqxqKSNt6yD6cdV197QRwtj+bUu+CeQSDb6agQ0dJPcXITDbJZBjJj152/rS3eeoRymEKaZrqeDEOeqUnk6KAz/vKbBomTW155sVa9ZWoEV2ofeDJm4AxAEIvEgNDI56mbFN2JNSz3YRVB42aJ0m1sRcy0gAAIABJREFU9L0hnJufoTkktphcgCC1+IFh7t0pWzMU3NM6GCviz5RS2+9OxMjZpC7GLpVNWmVM4KtLQPKUm+471tFVBIlt2hWr5F4ADWv+IQFTPXmraO0HPcbkRqDW1YNc+jQwHPo8vAyY2IJTsJXqNLmBT8eLrC1wIBqUJtmp0t6SPTlUGwdahoj6joQaiplhrWoNTTgGaLuzvCSmtM+HerAMYUNFaCbZQcOrEmFBURDJVlMfB96QOOkJBn3yD2u8EvGGShRyn67to95AJQZqRXhrxhCm+N/M/KQh2cg8WqEoXZIyYv/cmGvkz+RmGm8yqJun+sRl0DqKbIvOsRcbAzB0m7zbEIqDBCrWta1oHoKQaNRHu141pW6SCjQbDxjK0LVye8F0+tIWsTpQX+rWYKmoXVePrRSrG5yf4btrbxRHzfhoKhs3U6UWQKx4GRn1Eek9JuvVag1d5gQwoQ4r/+4LwIa6xNpNqBsDIqhP/7wxaNpRj82uMujyIyCj9i0Ca9feW4HKyMwtTENVUJx7PJqURxzdpXGtm/jUaU141mTZjJUDDvHSgLn5rPUp6jGaBPVnsQcMOS4uGPdDU3RpqI9BV5t2DxKL7kEaMK+iz0qytr4W3tK4LuR0o2Y+ULGXeNcngWXDBkovkpVHOtlzaY+jpCb0/dxkENG0WFiLAP7O7hIx4T71pSG5cbwvNgZbfcYgP0patRuKdUzP1a1hPQZf8TumnJ0mw8NwpTfMLSWTRlpb985ghE8AT5Kk4zzm0K7r05Tn8En0C4phwAOvydgHUWhhPeqeAgK2U37HAbKHAFmz4UMVUVTBQOTRZkw34UHpIVDtnOE2cds4oprckHFaC47nBcfTgodzxcMCfDwJHlbC40pYi/2c+0w4TISrOeHFTvHyinB7PeF6n3GYFbtJMGVpW521EhZhnFbgtCrOi6JIwood3p8If3h/xO/fH/Hz/YpPJ8XDWrFq2/nbtfifvn+t39wAf/vVhF99cYVXNxO+uAZuDxXXuzN2uxVzrsip9sQpMKZ5Z5Pt5Olw3g0Ff3otC0qpKKtpv4mpr8jQ5R3tpeVryS0eLQqO2m4maSaFEVzfzR4p8DutE+1Mz8SpF1EAtPZJ0OhC78xVbsEG6tP/sYjmeEDD69b3gHaRI+p8jMDFYFiAO3hX6WatS6Oif8+cs2MHCWVdcV4WNw0wppTbpCGl5Lxx1+dL6CdjNTd06EFS8YM4pQmKrRaVmZGnHRS2QuUhaRNt0m3/XUtB8YcpJsGB/WohEW6kw2DUiM9Ohwj0LS5QetCFb2SwwQWZVpmgPh0fjB5QSAmjxsiipjYt4uxrcOl/vq1iVdt1peDnQlGLbF6GLW6Z0cMLNK5R6MxCQ9hOIjcrifsItCfFDnIVHrj1MR3uU0xpGuvN9Ac9RXSUgdjKXoaJ5Vb+04e+ViBV90/oBvEZhVdwzrXhAdEwdbKJVO99hmwaXh3kKyZL441ZSH1VjWFdWsM87Kt9atQYwZTnztAOcgNhs8HpZjvDftkLoKLhSTwu3WQ63MkGGBCnOjDi+1LHtIa+vbqcJGKgdeiwyaOLoCwaUkXjGRlleA271+QS3VQmvvYcp11b7Oe4cSn+MiUnBoQRnpv/I3539c2hFEAqbVbXG0PySJMYAilEUzs/k8v7ECv6wRxANDaLrk9NyUy9NGistSdBNtRsdS1oGs5bLwJIx/CuQYsUa3XdMr03UeitiOxbr26Wd9qMH/TNhxSyH5catoEJYZNXcWn+jftyTFweN0oi2pJuR79S1/xjM2SAmmwygAI6yPlEukGSWjK1QLwoSrQt4qOBBADO2TxPwxlozz9vnq/Q3/apcdrI90bPQ/eQ0IVEgnqzwYScut8LjOZniXMlGM/xYDKNvgtHltZuCt96pIxtzuA25INaemnO02DMtDO+n6NdGvgsFWiQzoibHsVxgiA02Wg/M/oWVXV7y7a8BX/N1SIoZbXfO+5J3eJbQX7d/F0UdDgGIXFALtIw4dbN9+vNC9rUmpEs1r0Onq+4zlW72dQ590YuUR9cRVHOEGEf/vkzXO16JWbfUgCSCMom70s5W/0kwGmxoeFSgGWtOC4FDw9HHE8rioco7nYTDrsZaZ58o2dynXWtkFJAEMyuJtglws0euNoJpjkDrgc3L5F9bS3F7iMwqiYoJVTMuDtl/OnjEf/89h6/+3jGT0fBXUlYqp/xApAIChSFFPTff/1SM02YaMIuC27mFd+8Enz/FeNvvp/xl99kfPGKcH0QsBabMqwmZM9JMU+EnCfT3NYKrdVXi2ngdtuDvYpdYC0XiKrR5ZuGw3FYvzPb3xXroG162IhkYv/aQBU+5ePG13SMFDb8x42RwXmtzNz8NlFApJQ8op7aOo+HhzHq8TG0owwd6nMH0HPYuvG/43dY17WFgEzTZAbUQRd5ebC3DnuV5uY2rGFqxVRKM1QVqx+WUVRO0w4577yQDskPDDw/ZY+et8LUJl4udaDeQA3VtBFgvIiMKR653Ch54dlWcCKo1bRUvfCRzTQYqGYsk14oRwR1KWs75GJiVGoBqSIRI+92gBenqoJlXVFcy2t/h7QAjzGVz6g8qenkSy0eREPtz4kXoN3wiIa7EgnXtQ6JsNrSVKMwTelSqBL3UnFeug7Yjf77s0uY6AkBfkARqow6l6Z57Olv0jwGURhZaiFfGBplWKMOxiWoX1dtL+2NXnAgLMT1zjmDiXAeAhVMyjb7NqIY87VW+wxTRnYTszVNHUpIFGQltAS6kIt1mkVttBGb4mvbHpVaAa1D4X4xsUdMJV1EIxH60QOcbAJb2no3YD7R2LWGJrZqkQqoXQ8/6kQbg3+c9KG2Ym6kGNgmr7Qp9njOmUY1hhe9SA7MWCdfbM3v0AQIt58fJPb7qxNq2pCBhsQ6BqX5wkjK/vv1dD65wP5ZcdDlGf3npEHbuaXWSBUs/izSIEdKAzqwbUaimY6zVofp7wZ0oy1Q6TIjojV/oCdGy1pl+2cwmL6hz3LQI3n5ckuxRd4BmfsZF8UtJ+NWjN9TRDac8K3cYPxI0vb9Ywdq+77xjEQOg4Wl9clrnK09/ZeQA+NL1DT80dD3lSbadpKHQcU2Fj09kTk1j0KiJ+jKKMy312+g1Phxy/o014EcGcgD8YTbGYZh40Cb5ujPZyJcGL4vpstPtyTjlqI34TQ00Pa+MZ+EbO4vk6SOwX4jb93SXQfTeXhblIdXTN/yxoa3Z7TZF62lopwXaHEJZBXUphwYtqTSN261VqzFBznM/jx600EEUEJVwirAuRCWSjgV4OG04rRWLKV0LbgqcgKmPLVhRyliZJ88eYqyef9204TDzibYVzOwT4KEBRkr9jNjl905StiggFUtcEm0PySyFo+jV1RKKDTjjAmfHhf88OGI//z2iJ8eKj4uwKMCj8JYPcAIULB0U7UwQP/21Y3CMXpzZlzNgtdXim9fEf76V3v89a9mfPcl4YsXguvdisMsyFTcJDVDCqMUK5BkLSiL3RQEMl614/yIGerFyi7lJk8YE9JUFcty2qxgcs6YcvKuMA2oqjBImgi/ejETSXzEw7o1CoHE/vOkVqRs3ezUMGnBmW5TvuDB02geTKDUtaztxeWHj0SS2SA1qD6ZMrlO6Ni6S/3PmU2essX5WZ70GPDSNX5oARAqCuapSS8EY/KecyxxGT+fPJXKJTahIc+mjxO11E1VBfu1jXVQEmpINHYYtHi3DjX5Dadk7mz02N7euAFaCs7LGbUs7sj370XaZExR7AcLXke5hcRnWoZwAsPjrUVa0xCFTUr2M4iUIazCmrBodJT6S1v8AGAynwM5fmyjcWYrkhpaU8TW0RyoxtDdeYNTxAMiFANJzH/GoFtIi9/e6h/bmxcK7QY2n/pYEZ3sZ4oIeA+/YupSlqZFQDfjjjKaric2E6Q1T9ya23Z9UDdRyOMqMrmOPyau8LS3mBo66KpHUxOGFEsLpgrclL0YGWBLko37KBARibukJ/oO3cS9+73BPZETYfBT8QnjEKwyBAZhIATF7xF4MqbOBR7PglaAhXYfAmbt2zaXTchIA7nUCyuAkNFBN3KleFF32oQODZfLLjhSNoPPPBYNGOR2vuZVvkiZHLShbUOdXAdqn4GCoBfpqNtQJW5NKYBWVFiRieEs12a4HIkuGAyAo9mV/P6stUCLbDT/YwhaO29F/DnRC1ni4MEI3FwM34U2acUjS3gk0lxSN/rgBdvPlshldfRngsZsMs0XpCQe0lxHCoxcFM32o6WG/ouJJXE2ROaIFZXSZSPA9v2kfRLekmBT8kEMNza9Ut+s1uKmx0YVc29BNBrjBs5pTva9uJ0d3KQxLgkZ2eDQDVv82cAesqhzMJDRN+2jNjzeJZfv3DgrNlkKQ/O2QcVqJ80Ek3zU6z9B8vZ5YwtM0oZcDClVoAut3gq/hHlM2L1KeZDQdWkbU09o1hEkqAQVNyFSbGz9vTvcS12WinZmZSTTyrsnY62CslZUkBfdVgCjAkW00UdW92pVBRZRnM8FD+cVx2XFcak4L9W+XirEU3rTPCORBeDkDOynjP2UMaUEhmDKXY5skkTBIoS7s+LzwxGPD0eczitEGFf7jNvrCbc3O9weMq4mxY4Eu2wp7uyptwBZ7oKoe3IIgoyTZnwuGT8fjV7yh7cP+OVY8IkyjpWwLnYNwntQUG3QQWJyHGUwZ9Dff3mrzeTmD6npugUHqnh1UPz69Yz/7vsDfvMXe3z9WnE1L5jygjll7FL2A6kgu1A9pa67dYQ0Sq0oq3p0amrVBLWo65A4TMhshJRlXXzqOZi0BkMiuTHOjIYDoWgwbqD23jHIHABhmlLj1lIrqFMrbJs5k0akbYu3Aif2KR1vCqzRENVe/DQwn6Nz54EZvDGGeArYwBtv0cGDgQnYaoXbNNHlP0poxqTWyToJw1Z/2W6MUmxqW1172RCQdFHgJGskYoIWSEb78Jq8glNnuNe1Qkqf4qSUzbQ6GDnGIiGQYG3yw4TMaZP0FgmIjX3jyECFtCkLBk1zGHlj2mcNXx2KEZcwwNJEp2goHKFWfaod+EqXzYM9zjg2ASqKNCXMOTe6gLSgGTRPgkBco0TNJwCPqx8bBtpMR3wlG/ItlU0xYMAE8QYGfb0d8cSwMI0qxXzeHEFYfpA787mGkbpUn2SVTbS3mTKxWbXGi07gBpkmg6Fhok0bUsJzm9lONeHN732ZBCeiyA1VSS1gQbVvWcTlKiC2qQ6jp+/SgFO7iF9uRV5DYYWfpDb2M7nRGY5liw3HxsALAglv0+WaNlE2mv1tsq6AqBqdYCB7BMfWvvWAFmX//Sm1tXBMIEd5yp9PN/UGDALVFVVWqJYmAeqTZi+kkXpFPvIzI7wGZnCyj79TnawuTyZN3HgbLvGdI0kzmmjfPHg1ENkKoyY7PsrwuURxHsSLOBdpmN5FYE/X8uoQCrQNCOv0pz7Vw+CB2WAD+03VNoSCEQMYSc/UN5CtqaOLMK+xwYj7XBpSsg5SOjRZWz9/YyHGiY0Q0aAHdGFw7Q0BR2CODM3cQO6oWttkGMMkfXAX9wK4QRUCC5g2mNsYTNkGpBtYx815mwZLyC+GtFOiVsxya+KxMRm3d2LgitneYVHptoRmkJF42vumS5pUqr9tdLg/e6LrNhALvUAWsTAZSQMZajQk+4MfywmmVoesxWQTZjuy1Ezy90Sta58eEEOJTVokCtTSZSw5ZF0j51w3YWBB9iGk5n8xDXofDvb3TE/frmvIZRlFImrdiumlKM5LxXGtWFdFreTyFGmf2akWnEVQiC1kqCoO0x63+ytcTwlzEuxmIE8CJLFpc7EhSGbGPifMOWHKBKkrmNUGyPOEaTYvW+JkZLxCuDsL7k7A/Ql4XAinpWI5n1GWIyasuD0wXl7PuDlkzBkgVEzwjZkAwISzJnxcGG8eGX/4tOC37x7wx09H3FXGWTkSQ1DX6g00Q9maaU4eIOTeRQaD/uHrV1pFsHiWPREwMWOXFC/3wDfXCb96mfAXryd8+3rC7QEgXXA+HXE6MdYVgC6YZ8Xtiwmvbmfsd4TdRDAvn/ohDBBnzHNGngRGg7JJ4TwlQCvqWtu0mxvGDZ2AQd20ENEB5vztRs+YpkjTzIW+3IrNWtc2EehTA23awpENPJoL45+YOLfVmw44ONKNYa9xax2BJ27siwlBpPTFKiuMOSZxocHpHcVE17fFTnTzsm3aRmoPMlM3moZcQlowQt2gyEY3c5cY2IEmRZubn1N27pX6cDSmGD3Mx64xOju9Tf7QZCaRehVhLTxESa/LirXYlDbnCTtPy+oqCQ1vXpse1SehTH6t2SdCoeeNNDFVaGhUB2pPzAdErKhKOTt2qUsxyF9Cca3FC3tycamO5rVhg8JDkdeLAGnNWJcIaismLtm2o3FnE+wwYP5Szr6V8XukFA+AkT71UgvNAvWfiQYKSrQBZkrijUQkrmUUJ5xHz8KwNeFxeqMX3HUdnsVuxu18avQtQRTvzN4IauO7NslXC0GJ1bnrUasMWMxu/G0r8WHiiSFNkpkh8TLzZz4l8yyUtXSpGxMm3+61+HN/0feV9UB2abpNcfa19HVvI5bowGvuE3YPXbciIT6XYWuGsXnr8cC90R09KEMACqHaoENkmKBzX0sHSoy2WMY+DYzPPvVGpOmq7ewfhBedeuG0KmqZzjIURDGB2j5LhIseYIxTV2+WfPLX0KIx8W5bMd+21rphaY+abxkZ1whDr7SQGvWNUZi3O4+64whbfoX24jq2rFDqzdwQLNPsGq24lxayhotsBzv7pWFXY7pPF9P4Kl17LZ53MZrsAnnYmhW/f54mxQ4aaQw0m2fC1LapsdwNdPEQKLWtmzsTB6nTc0nK/GQzLMBF0u8Y3c4bCouENyjQxkMx3RrIgRWuPfbAB0v9exRPXhTpK6KoPzYSUgFQ6dk01WYAHn7mZoyES+ja9yBIBVYhPBzPWNYKYsJhzjjsM3ZOBSrwIUzwuinM8zRIpPpAMc7xKrKRST259sNQxLTZ9rsVcc8IJ4gyTkvB/XHFx88P+PxwQhUgzXvM8wH7/RV2XuuVuuB0PmKpq0togSlNuJp32OWMKSkOO8LVnrHfMXISZLZhErsGOzJi4hxVfxZjd5vAYE2WcumTds4z0jyD0oS1CE7HFevpbGoNGQzbrlVfq2AV4IiM9wvjh08rfvvLPX7/7oiPC/BQyRIvKYFUkJggI922PaPdc5LI6j/6x+9utNYKdr0lacUhEW72Fd9/NeM33+zx1Qv73xOq87IZy6I4rsC6CnIGrvYZ+5mQU4HKCujqWr+MsgLnc8W6EooKeErIQS1hBaGCEzBnYJoYu5mxmzN284TdPGHKyVYPKZshYgXOp4LzacG6LlCpOBwSDlczpgwksnV8aMRDBlFLaUaDbSBC16zZynOIzeZelKfBELHReXmBEZzSzSqK0FjUNKzb0IIqatPA5TwhZ5OElMFo1QoQnyzHtD1Y3zQUB6yOHOzoAi9GCXA6jNQKqT4tcDlPIAhTY67rJrUxjF855TZdYTelxsQipBudZMNtgj7qPMmJMatrnkOjjYaES1aUq3isa2paYktspK4VwxBGgT4JoSE5kFOQdoepluOdwMMBGKu6tlhwdFZM9NFTBVPm1gQV6eaoOKT1Qr+fHNPIIx7NUwoo0FAD1jCKRtPgr1sT1YXx1+7xIZrX5VdG/7EiIHnhlS4waIqRTy6dLjUY9XgIsNAL/Wn8HClz0+V3skd/frKHREFl0DJrKzDQTFE9YKFWSy9s/oJsfP0EHsKWIp3W7ikzQQVRYatbJlAzHHUii/YXin9O0WywY0o36y83qJbqKWlkBr8WzhVng/S6V7VLV+IZ04tJ6Zh41yjjLUVQhiiTrUfEmuba1tpdK06b0C8rHLhTbqCoXuwwwgClDVUWd2qtjhQj8om2N9zxctat+KQlZI7wB2Vb4xNfUGhcJjUY7TFoc3vS6kCKUjSjMYap3Nbsxm2SbabC2rZbzYirauFQjTzTwn/7JkZHQ2nfPqmORKG+r4miO4ZDiezF30I+0LW1teiGUNFDTNQlnWgNaUu3vMCeRrEP1TGfsAMF/HkoMqDeIgBMdAjEGt39ozaamrH4klzCZHSuWmq77jnnTTIjGlI2tP9po4Vukkwdw85081w3gk1MsjfBe2ghYK3x2eR2cNvWtcJRtljgMfRHnaENlfa9Wgpma4y3frOOgNRuYhwMp1J1s30nl6a2z1jclIiBfR1GPhVQWUEupzutjMeS8NPdgjcfHvB4PGE3JXx1u8OvvrjG7fWMPIWWWh0FGNenm4EDWiH+/nE0w+bziSZX3DUpHnjVaobEVrA7+a2swLpWKBJKIZwWxaeHE+4fV9wdz6hKOFxd43DIeHWdDNtHAqlnVKk4LhWPS8XxXHFaBAwjzl1PCTeHCS9vJhwmRp4ZDJfoUYVKcS+ODFs1kx2yZ1rABxoxsDDPXDdom2Y93ltkBlBJOEnG26PiD+/P+N3bE373fsHPj4JPK+OocP9eNZmioG2FR0lh4DPjcWJiZGfU0//xj7/Wb18lfPWi4MXNDikpuCxgXnF9AG6vMvY7IHOFyGIvdoqXbkHOhGmakTNbABQVc9GTIPGMab4ByQHnY8K79yf8/OYeb9+dUavpAnOeQYkwZcY8J6QsIBRoXUGuo7WbuWKeGKAJtZiWKGXG1XXCi1vCq1cZ19eEhGoz8Vil5JgoDR19rNIGw2bXybpDG7W5mUPnGyYTUdOXN772SFG5NNDwSF5JjTKCgfywrqVpH6cpN/RRKaV9H/FCprvAjeKgKrZZYNro5npBOyKz1GUURlyg9vdJ0/Syc051iKDlIQgiDcl9oXe2iSPa5A9D4iYNvGPOufGizThhbmditgCdOJhrNwkl5v73t2IIwwRMBwbrFltFG0wghtV8bSvbxNmnSsNB3EJPRrNjTHqraw11GyqCMRqcNgzdWm11HvIoaVQcbajGeEhH9J6EgcnJOpspSdCeYpo1YPVqm+KGnMud7kRDgbedhnLgEnmkGwxEiyFgBqSbQ0ZEUbQ0iko/wLXRbjAYMuN50WDYEreY5Utm9kibMeKMExyGzdb4taHt7DKywczaQlRkWzAOpj+9oBJ0yZv2NNgWZlTNPOw4QtEebT3x1IgzUXjH/ZlytgLe3f8tgh69GbANhvsruKfoCaSbFH2yG4xda1SkTa3ieo4BUaMptgZOJ7wCLg/UhhAjf2GkVtAR1caa72mh3J7/MQQIYheLQe4wYjNSl2o0qNr5+mPyqD33do9EkzNuJaLBt5dpwjRl5Dw1slGpPaQIZOtoJTduQ7qXgEObGueNDCzrQJN6w2QTDpNlSA8IaX6gIFNIhNikFhzXcuO0B/tIuTThKQzitEVMhpFchmehAwNoiL2H613TZsMx3us6bBWiYI9fPQp9M0h7I6/rwMoOn0ln2YTPSqq2TbA918MWQeA+FnoSwBRDMTtrU9/uyIUuTbtEpxe/20arD4swRK/TNqimJTymVqzHJFth20saaC0i1ri0EKBxgHYh5SprHd5BLkeLe0FiEDVsfGSTS9w2MbUatlLVJLsJFeQb6qIZC2bc1QmfjoIf337Gm7cfUErFq9trvHpxhUMumMmyWm6vMq4PE6ZsnWWtYwCXk06G8KAuoe1o2qiNmjIg9W1ObYNIk5ita8X94wmPD2cIMs6VsQpbAX5aUYpASfHyZo/ra8aLG8ZhXzElY+vXFZCaUArbsyAChUnhJiqYEmE3JcxTxpSteCdSF0rVzWCi1WQWkYiqBPFwnTihEsJbYLISAeNcCediwTg/fDjhv/58j39+d8afPle8PQInJKyUIU6KYtK2PUDDUoewllysFGqNmKv7nfC//acv9TdfMv7uW+DL1wckUpyOD1A5Y94xbm5mHPYZeQJUFxQ5Q3S1m7/aRI1YQGSg+TQlfzgy1gWodYbWBFkT1qo4L2dgKjgcZuz3e8O9SYGiRBg7VBNIJ0jd4/io+PT+AY8PZ8w543C9x/Uh4eb1Hi9fzjjcACktSJMgBfJJzBgEsZdBS23cvLQZCWJTVk/Tqx4PzZwau/qSp11rhaC2qcv4II54vpiS96S7Lds5jHbxUgyz6HOc2O4k79KXKC6jwG4a9yEyOswsUYzHi7+vIB3b6DroshZ0iqBLVvzGkjIYWt1cgwsqyxhjHtd6TA1VBRbHJDIz5tnChcKI2pBUiqHYwoWhqa//AfQmSGEmBue7jnSNkb3eNKPEjawx6pCZQys6pDAOHO8YtBVZ++TTP8PxM9oyaLfJZ9ukzKf/6Wbg3oBtUtOGyUsp5YlcKu71oJ7oeG3jekA29IM4crOHGMUkR4LrDTSzqEKsKXIOuIpgdfxh+BxoYMKqlkYNGkksNhSlIT5bG55yDN/YGsg8tXNg+urwLDLli383BM0Uc9yr1k0gRg86ugingSIl6oV4RKk7ez3oTWstzg3snFlqmmj7vXPmgYAhTdYQaC4bzEqTi5Fn7YWpHMOKP6RaxXGrKWXzyqR0MaHsxZg1amVocHoQChE35GUEimjtBjEa+PxuZ/TnjVybaxSFqrWxnLNL3OKFTkIDFg8Dmo6enHkx8W+yJlWsy2relMDlUWf5B3e8TfSKpTqm7GFk7ImvAChTZxWLeuKvhxlB2ouUN8kK2nSz6jKcNoUtQQOJABdP1xTBuvjEWXjYEAzu/Y2hL3wL1M5ra947NWWMiB/PgVEmsNlYhYRiMLSO5myV2rCRXa6HNp01H4de5JTxE5qKme6C/oNWzFJLHaRGvRgnq3EWBCd9HFxt5C5DQx1+rNgGR+r1CBqIIVAMx8ZBlDWlo059MN+SDewCj2hFaQyAGBFRe0kpIZBNyC9DiLzdZyWbHA+Spi4l656hnqVAJpcYUKLiOF4Bo2jCwwL88umE3//4AX96u0B4wqsXB7zcFdwbYOdNAAAgAElEQVTuGN+8vsZXL/e42RHIi9Qo+4gtFE1qAatYIvhwZmIb7NwGaq2m8VrjuJSmwU+cQQqsRbAUwbIqTqvitAqOK+FcKh5PBcdSIATME/DiesLLm4SbfcJVVkwETAnI5NsHh18U/yyCUJMnxsTUgAuRiN22shtpTaTcpmbUZY9EZbINQ9EJx5rwuBDe3i/4wyfBb98V/PDuDu/uz/i8KB6rjXV9J9LOBvZkXAzBiO1sis2l6AXy1f6TH0+CqjMECaJ7zNOEacq4//wRp/sF54czrq8FL17sMO0nR28V6zpSHTrSCVKB0wk4PgLH4wkqCfOsOFwlXL/MuLndYdrtoekMcIHWO2jIJjzJkV1TqZWx1gXpc8WjPGKCItcZiQooCY6PdyhrxRdyjZevrpEkKBkK5WrFfGbUFVgcWyZV+kqSbRXKXL1ggDlnqTknTZaHbfRvyskMX0PB0FZvtJ3cGEfaOZcDJzlc3oaKQ3ux1mJTpXmeXX6CVqjEn5+maTBbdWkFsX3PmDaPQT/WBNjvvpa1Tx0gUGFfvybs8txujm2hCnCm4YAf8Y0jXkuGQqlssGDWNCTM82yTP/+6dV02spyUEyZHxzHzBelFhul1aXzfQESVVfyGj4hn8m5fnHrQUzzzlJDAQOLGHCUvJmutxk31zcs0JSinnrDIgFJFSh5OVGqTG0kVZA9QIqLWHPTCsr9A4v+Lr43iuk2uL9zzwUEtpTTMXdwPPKzfKWfHewUxRQbdf/aiCRukYDMNSWdJJ2bMjYoiGzJExG2LCCoEMycrhJpkg9pGQrS0Nee4rgUrmATEGYlzK7rtPaltKhwv7pQY5mdNQ8Y9LpLccitOuwfETUUMpCn0p9qkPT1NVId1oWO7YBK27AblTk9yAgsT8jw5xWfQGQ+BGCNVYiRiZA/SsEly/6z7Vs1+VqnU1vbMFnI2zz1YaHweTS7hWyVndweBRnmG5j55TM6etec1ZAguUeLNILo1C2H6kyooFRv6TBRyIiuOuliI15QwpakV0ym7vJGSETacatRTiH1N3+QbPi0WBkkCIW0oO3VVFIgZRf3erMXlTpkwTX1QwQnASm2zaJNwtK1QcvIL04XkJaTWjpqTIdo+BhUpdS16WSqkALVyX++3SPS+acGGyPRUKx0m52mahmkknrDBxwY1dMUxSbV7zd9xPh1sSFSXSY6Bdh3t2rcs1OAIA5vef4eUEniXehLk0LB3pCcNz80WknNZkG914lsGebyXdDOc4WaAHLed43U0LCw3nnvy321TfBOZH8C1+vEtx3Ci8XPpMtX4fZ/DG1phmzn5Nej6/1HtIyUSHTt1CVxRlVAruyQiuWeHQFpxQwnziwOmXwEpfcTns+Bqv+Kvv73Bd19e4fZ6hxkrSEunzQhQxc54uJE0DSb1y+Tr7f2oKGvd+GaqdCN0odowrnOebEPGNqSipUBLBWoFC6ApQSvj/rOgPgrKNVD2wNUsoL2ZLJkiDZ0x5cloIaHRQYdhKHrTI43W45kAFB6dHpJIAZugGSdhfD4R3nwu+OHDGT+8P+IPb+7w4+eCD0WxFoZwxlJjqClIhCHGzKbp8Pon0/YstpBEhXBvDmTASOVfHgj5jT2U3y4FL3aKmQApO6yL4O5U8ObjI3b7BdcvJlxfTdjvMvazYmIBpKIW9TRAQmbGyxeKr77cYb+fwFlRygnLeofz8TNqMVQMpwSm3KbAQsV5tYSUdkjzAXI/4/xwxPluRjnbheXMmOtkq1gtSLwDCUHWFZWWtg6Ne5uVkeaEXcqoVVFWxbKs0CKYptmnJr6iTE5G8MnOspY27Q1tJA282MTczEXiGuaIvd/tdsacTAkk4pg5YK2GzqtDYZAoNfNp4ox1BY6ns03V1tWoLyLIzjuOyOU0hCtwJitsEzvgXlzJ5VWnDFgrL6yST/DU9X+Je9JVywJku3m1ENZyBnO13yWusJC9ROGrPHg8uFQQZ9eDCUpZsK6rF7kJ827uATnxwPuNfR7e/L0o7Vp7wx6VxrW28ACb0q/rgqqGKgIYy5nw8eMJ794+4uOHMwiE6xc32O8nAEdMvGC/Y1zfTLi6zphnILGCk6Ku/pktfYJXy+qT6MmnlO38aca3UlcklmYgFQFKMZ1aSglgacEiUQSYobO0Rg0eb20a/47B3CTGiRUa0l6alwFHPRApJr0qZO501SdhHsyGbWrwCbbmJbT/TQIlPaQo/l3mBKqEAvRi201USkY8Uc4WkuRTpnDVn08mF5iTYt4p8nTCNIktryRD1MxanBUp23e04qa2iWB4FXrAhxVRdl29CfN7rUU9h7SI+9SkU0si5TTYtD4ZYoGyB9A4K74PJLUZGZtcRaltiYCMlHr4VPtZm3bSXhDzvH92qnmJPrMJn7TpmKW8EvKUOi8ZI7+We/PvU9WYxOXJmzfx5nOpEF37hJIIRQpqAZgn7Obsf1cv2lqceB2MjHFd/GVoBVSfARtWM64fj+ppj5CuA4GEhokpt81XKRXM6qZ6QJO2Rnk9azdFFvuzAvs8iXaN906OROORMjLQfJoXQbr3BP6yp8FIGc0Cpwkei9ACu5p5XntCCrUQmP53RLx8bDpqTPiaVIKHjVrqNCxst2Jw7KNSZ3qraEfUab8Xc0w1iS3pUwScsqHiZGSHa9fYhmF2MIp6hJ59goIWJlNK3eZgYERxAkh6mUnTkaXoRJiUkst+ho1WyKTCz+FNUKKMCkWp9k/QPXiQviRPkg6cs6o6O3zAQ/oWbJUeVmST04Q0zwPSUze88/CZLHVIuAzkIbqJeZ4nTP6+Cu/KafXQHF1bpa4AijDAM6oyHtaKu8cj1scz9iB8vT/g5T5jD4DWCmXbKJRqmu3V/26tCtJqTYhWMGcoJZ/eb5OgO/lJe7pykHmUbQBDjKIKcEXKnv8yz8jZ/uxyLnj0DYmoYp5mXB0OYK2o5YS1CpAy0i6BJ0XFCpFiRC6NyXbxyIYE+PDFtgHVjY1uWk8JiSZAJx+eroY21owFE87rhE9nwvtHwu/efMZvf7rHD+/PePtQcLdaLDzYin34s5iHYSGGM7U3iybZ40B9OrZZwqcxLrqIOijqH7661SQF+6R4MRNeX2X8+ssD/uq7K/zlX1zj9UsC9BHn0x3O5wegwOUmCZwV06zY7Sbk7NNAFswTg1l83VzaZNaMkwTi0uNfIxY9mUtdmbCuwOnIePic8HhHOJ9moDKgFfsd4fbFAdOkVjxlwfXNhMNVRp4TRFYUMW1fKRaHHIlyTIyUp2YgG81YWwOGpyqFgicoGdRNdtKMQ9QCODLlIZJ5WPkGoF+k4QqlrXStMxZV636rgDODefIXnmA5e1pT6+RsLcokfSVN8fKONXcC5TAxblFogUKiMIe4WbIOE1XOGZTYp9OEz58KTscj9leM65uMlG0C19FSLhdItsItdfWmbEAzeaR0StyMh80QxuOui9sktjGSx3CiNvCM4KVIIazQaoWWrXxtEnpeGQ8n4O5B8Omz4Jd3Z/zyywmfPz3gMBV899UV/uL7a3zzzYQXN4I5r8jMmGgCNEPV+dekEDq7BCG3AmsKmg5p49eHxALUTZ5FpEkJbGVOPsmugy7Y9O+W4mb3YJVquluXczRMpXQt8JjoOK5Uk4dxIOQdHQ+BbnMIfbl5AVLqBrigxrQmyU2TY0iICJB4aoY8idUf+3VhhlLyFaBNPWshPD5O+PmXBT/9+AFvf3mDm5uEX//VNb7+NuHmFtjtFHPe21oXgNIKRUFSbr/7pWabHO2o0D7VEY8yl0hxDL53SK5G8gc1ioJWa5qJta2yQ7vNyaa6tIkwMvmWekMqXpQl5l4Y+oSwS2tMtxwFK6IgCf00DfHeut3ESdswVees27Ns5ijZIKbHWGszHAJaYzthoVbr6jSmwdCtABKpp8q5XCnbJiDxiMm0exkSE2FXV0ukTLIrOqRpiiNenjyenlNyfKPp4QGjckgzx+OCpX2ZgWA/85QnkHBb13cTcze2BRY2GuQYZ42Ger1IS3libmdCLWgJf1I99EQHcgm6HyOePSv8tKEnWzHj3szkRU87JwitYG50mnivOIEqNOa0SUXtMh5tvoguf2nnqKrJhy500kQYpoajxwOodR2Cemjghku/P8PQHBusKlsEZsAsw9w8FPhdC23bnQ27PljkEhz3igGcDfbNKbmsreEXteMMO9UKTWrFlPxdEkE/kYKtG48WCEPmAJoWXrS2xFyp1b002b9WB6mbPTNdcDwmSpLzsdmfKZNboYUJEopmHFfCu7sTfv/TR/z09hFp3uObL17gb7/b4YvrhOv9jJkFmewFXBRYi2L1RkSrONfeeeFDmMy4SWHXx6MNIjw0jg2aIUVwEv97YzDtXh/ihCKEu+OKj49nPJwLqgDzLuNqv0ddFkDOeHE148uXO7y8zdhNAsYK0trRm2CAfeAn3HwukU1XfaADzhCaUWrC46ng44PiT58K3n4+48PjinePFW/uCt4dK+4WwVEYq1KTSKVsONTaTMJb6e94rzdvAXELTeveiO49G4eLuAjNon//9UutXuwkVUxUcWDF62vGr7+9xl9+e4Vvv5pxc6jIesI+E3YpgUOLJ4J1OUOlgAHMU8bhsEOeCFUWVD1B6hlMK/a7hMMh+cpUwUj+YmIQW3xnQYU1qTtAX2A5Zbx/c8S7N/d4vD/j+maP77//GjdXM3hagXpCKUfsdoT9wYyfcHVUC7AIk5VqC4gx/JL4C5tbMlR0LU0nnUKj6Mlg6tpO7fZ4DayYpJZ6WEpFEdfjptxevsE0DUIDDVSGWgTndTENHdnKuVabUK1SDTfsRV1mw++IGvNHsBpGsayR74c8Z0zzDvO8s+5WGI9nwsPdGcfjCYkI827G/rAzTaooigfPHE8rTufatGqJFfsd4dXLGYe9Ik82bTI9FoNTtn/8oAHEtJGuWcSIsNMoPuDaWE/JipeG6/BbCEtK3cyp2oqttuJxja1UAWnyIIpwOtuLdRVgWROOJ8anT4I3v5zx88/3KMeMnGbsDwVXLxS3t4Q820aHXXuUmLGfCfNMmHeKKQMcFBVmMxuHFlGMqEOt8PVr4x2vkPbClqgldql0Dm0QaJqmEnJhWJI2SQmD0mj/SSljmjJAE5htorGcC5bzgirVwxiSJxNqlwSAW2CRFfXVDXwmEbHCU7foPApNpslZQC7pShMEGdJY0gTlCecz4XxO+PnnR/zTf/mM//zbO9RV8MUXe/zd336Fv/+7l/jyi4KXL4B5x8g82cSkLhA9oerZTqumu/Q2wJtOHgqpdnBGYS5RTEjTKvqd6ueBofJymkEp+726WMHZ2PEDMNOvgQ4EgTHsBhpFj9NDCO2lbKx5YJomTLsZ3AgueDLljkKDPOXXdPrSYpvB1X+D7NNFMw8qhaEsQYWdzbtAywKgokCRs91r1JqU7ilJbJs49WZ2XQqQgDyzF97akLDgAMHEMz4kCBup2CRfxVMpBWY6E2zQXu2jDb13Eayrmfo2yaRBIhoaw+Ci0zDRbYFFkXs6FExMnTylEAgbISIK65Am6hDVPuqZTZ6QIcItRTci1qGEpShOpxWn0wImYL/POOzsHUUkDQMav0szTw6oW+IhwyG+vw8lmqF+eHdt5Cw6rLtDiqWd3cwpNckNDZujCJuxJFP7i03Dzwg1fF2H2HjW5lVAbDpjclt9aCEVVasPh6zBT41BbaEjVUYjZcfzhTk2jJfNcKkXSa+EQQaUGj4vDO5te9A0RT15uopd1+zNcEo2tKtS2t8JTv2VMmAfQYQqaKhHOwatACcmO0vCABy7FO1pp9D4fKTlLtg9NSRIuidNKGHFDnenjD+8OeG//uk9/vjuEY9VsM/Ab14RfvPtFb7/5hW+utnhalJktfOreiMTTYXVREb+WNfiwT11IPn0sCF2qS2RGZzBjOIpwBU2VDE0nz/H3kAel4KP94+4Py1AStjtD7i6vjbFxPkERjEP3yHj5kCYsxj1LntSeUgRyYZuEkQWJfu+CihlLJrwsDI+PQLv7ip+evuAP3484//9sODtw4LzuaLAWdycW/iXDDQqqPp7nZHT1Kc7jTGvPR8i5Hah+ffnUi8pOM+FWvjnnlWT6ViSTYMWIRyL4t1HwW/f34H/6SMOk+L2QPjyxYwvbmfcXnlC0FXG7WHGbr5ChmleHlfgflE8no44nQ3hspsO2M8H7CbGbhZQXpFJcDVn3OxmZFKUYs7iVVdgysizYjdVcMqYD5aEuBTB6eMJSB/x6uUeh2sG0QqiirMKzloxzRZRntmmGtmLPFZuHerqKxB7mU3NGNnMEF6+FqrGfkwEnuxgTKGt7VAIM6ZVgRSCSEKtBY+nE9Z1QZ4m7Pd7sBT/QPxQ9RdHTtkeCrXiu/rhbWzpCRMxRAiz6+ZAttIknVDWiuV8BKggp4p5L0gsLaCoFEEpwLLAdMuYcDwyHk8Jn+8J66pQmpB3e+yublA54/P9EX/88S3+8MNH/PLLPQpmfHG7w7/7N7f4u7/5AlevrjDRGYQHVDm5tIWRaIboBFIPI2hJo0Zr2Cai1e4udwpNperJY05wGGYga1XIKp0zTvbQ2MRXGkoqGA4mLzLqAbzYLVKxngRLMSzed99mvH51g/tjwsc7K8b/+c2K45KwVkJZC0BH3Fwrvvt6wvffHfDNlzNeZEZBhVIxI5qYmSwxNxJOkGGYFUkYKKEr5j418ZunlOLXyNfHQkB1TXsxvbRh4tTX+opSjIvajGmETplQ49bnUv2lZ8/WUhRSGbXYBFprRVlXMBMOuxlzTt6nCxTFiwjFNCfM09T0oepM/VJNb2vNXwJn4y1xcn0pFUAzBIyq9lxXzVjXAx4ervC7Pyz45x/O+OXei9K7R7z89B6/OgMvVHF/OiOvQKbJWbsCzsX+frWGwpqcIRwqpWEtT/ZcVXO6k3JLaVuKOe8xvNhtq8SYJsV+nzDvzKxXJJmuT6vHEGsr/i0YKqbnpqcnDnFaTICTYaejaCkLQG4cFIGsFeUkQ+jPOJ3sZjBDpxI0+fRYihnmUFHY5Q91AokXZBlAnrHWHe7vEn784RFv33zG4+cHHA6KX313wDe/mnB1YKTJNOR5Nzn2MkMlASXheFR8eHuHd28+gZDw+qs9Xn8xYTrsAJI2DR/54Eg+rfK9gFYntdRkZ2RVQ+2tthkLmkloXwEC52xa2cpYViMp2HrXpnRSO4u+STRkkKeY4GAIUbOiKGXD23LPvLG04hRchI6ltKbLyR9F2gbFSDROhUorit0h3sAwasl4PBHefTjh/cdHfPp8j5wEX395wHdfv8CLa8aUqskvxyhvAEy1afUJPYW1W8BTm8JCF5tEcg9cMiIOoF44+6NjTZ86gUb6BoTJ+MiiLgWDoVNLEUdvd2NZyuZ/yZ5KLGpphasAaxXcP57w4b7i7lFBpeB6Zry6mnB7PWNO5jOxs8wkYazSzNNpAoQucauBOgSoDlN6ivc2gRK3wjWSgEWB9bxiraVtAJKHzjTEX9vKuESlMb6DCmbF71oZ61pRZEVKhJwSdsl011RXM5enDCT3MDjijlDbPdaGJLV2Wkzj/6sn2brJU9RDuyxVWusEKbbNFWYIZZxqxru7ij+9ecSbDwvOVTFfZXxxu8MXNxnX+wlcgXJasCwKIUFiOwfrwOJAsnMxu2yvlIQqgVr2TYF03CDABqgAY1kLFhVUCfnHYvcaMaoCRcW+phSAE16+eIGUE5QYp9MRWhccZsYXtwfcXk2Ys2KXBJkJU7LNvWEN7WyHCIoAx5XwsAAPqxkkH87Ap8eCdw9nvPl0wpu7FW/uV3w6VSweD88pg3dWS2WXHZbq744h4ChkU0Y0irEMDVvNHuZrG7khI0MvzLb61JyrF4CKvNZqXWgNjRtcy9kd9g9V8Hgv+OUITG9XMBfktOCQCYeJsJ8nXO0yDrtkIvtScF5X+9A4YUoAQ8C6IENwM2fcXs348gXj69eKr19NuLnag+eX0LXi4UHw8Eu1G0dWrAvjfD7gJAlrIZzfLvh8Etzc7HC4YuRptuKzAtOqmLIiZ5O+cDObuIub4Zo012NqAqtPQJobPKZ3PsUlAbEdDjZxIpDD24HkkxiCasbxWHE6PWKtM4h32PMekBQJDXZ9CZh8KlrFKR1MmHZA9rAIe6iTEzwSMk+AMqowzucV9/eC+zvgfFIQCfYz4+XLa1xfZRBXzLlgUqCsBWsFysmA+AUz0vUtkhT8+Kf3+P0P7/Hx/g2QDuDdFVYlfLo74t2HisdHC+R597Di8/mI3/34Bl+9ZnzzmvDyWnF9Tbg+zJinnWnROSP5lDwRLBSpbQ6KR9d2GUaLxtXOtCYWPyB7YIi6qQxDKIGqdKygm0KtL8pQTZDCjaOuGuvaBHByJ3lGmgg3qeLqJuHrb1/ifiG8+bjiT//yiDfvFI+POxzvM45CuFuAz2fBt18lvHwxIWmC1uq5FA7ZR2xUesy7DgYpM1MKtJbGDieabDrueKo2QfJC1+Q0K+p6RkoJ0zQhpb2ZVquYzEG9gAjyjgjONaOWHmhEiUF5B0XCw73i04cjPn5YwKx48aLi5ga4vk44HGxLQ+RpZJmwJsIiCtE8xMkDOnsCXCUr6lGBtRqFtSRUSahiW5tVFJVWiO4glYHdFdL1CeVhwfHujOO5otRPUCju7w744pVinioyBGW1BsIkBAWilqpWSkUpitNScTwXnBZBqYylEJaVsBTgdBaczgvOC2EtZjmrnmzaSXu2+9tNwH4H7Ge2f3YJSQFGxWGf8fJ2j5ubjN0MTNnNN6weH+0Fn9gzvRTC6VTw8HDCw/0RtdqZNE+MeednU0iBKPkaNzk1R3FeFhxPC9ZaQMw4HGZcH3a4vsqYJwLpCtYVxLUVkwknJDes0pQhBHx8IPz8M+Gff/uIH//lDvcPd/j2u2vo7oAXLzKS2OT8Xs+oqqgloZYJp0fg8b7i8f6IZTkaT/ibK0xzAieT1xialDY69MD/EcLYClBKWI8WTHR6PGFdCuqqQIkJHGFdOzPaJvYroMX01K2b8GcNQTex5DsrFNgbcuPvSihv3M9igTrFAtVg58w0AbtdwjSZXC5Rfwlbge9bJQUA24SYidk6isaq1ig6bBN8qoK7M+HNR8L7Txkf7yeoFPz0acWPH0749vUB39wQrufqUzbyoWoY4EKG4u9hoWYmsw1hAcSa68TdbK9sWutVCcWzOB7PBQ+L4P5oG4QixmMO4elhytjvEm52Gfv/r6wzaZLjNqLwywRQ1cvMkJIo07LskBzhi0P///fYDsvhkBQSOcPpBUsifcgEqiifeOR0N6qQy3vfi4rQKwKanevg33d3mURQhKWjLQWIBAkLrljw6zPwn5/v+MePN/z714xLZTyuDX/75ogfvj/hzbpgiRUkbE2/dLN+sj0/RAB3cmmdh+f17sZW2bCvXiuZ18qMAiO8a/hXSmmo4puSGP19GVEJQB5BdTxlKb6C8TCcAKGA3J0m8vGOH3/5hF8+vOKWBacV+MMXJ/z56ye8e1hwjgGJBMDdGpRoW05rssUHQ7ut+ijg+oZunQmTgY0Ywna2bC+lIEQEWoF4wp0UH2vDv3674J8/XfDflzuuXXCIwFcPEd8+Lfjrl0e8WQMWVgQxNYKypUy2nefLhrjdMYYmuYjLAsXieREdVUxOMrxyzYEFpWbUKgZ1jgEUArJUNFUIGmqzjI6uiiUmpJhsA5EFkQSPR8bj6REPpxWn1TTiwaUjN1E8V0IWxmtWXLPgNWd8vAk+vFY83xte7sDHAtwacG/dnrsmyKWhNMMmagggtTqLhTxAR6bThJzpHgNN3OlEtDZB3wXb6T4Xaif9wj5IaW+A/p1kbZ9b8Fneyw/v/6jWAXszxNGYy8PV2rf0RJ7A8C3YgyM7t7Q5zH9vCvLQCgbI9ZiRgDV2JBKkpDguhNPBoOsjgtO+C1vn5dzM9DXNKENJYN3cIQWsC2GNhMMKLAtjiUCM5Ostt6nDMHsxJktbU3uYq4xQD9udWkHEiEu0A9iqpdwxbXzXITVxaYjOKNvohYI9eGFq4Xw90zf0Xh8pTBzwsJ43w1ZvPk61hzPXCmLrNnNT68KbgjQghhVMHSIVgRTnc8LTwwMOa0KHabibbCEWTQIuJeFSCB8+fsJPP3/Arx8+oTQC82qhNhz8heBGU1IzV8Ux4RIvrg3DZvIXIDKwBMYayC606Jg7XxPXJqilTKc6cZjTshF2QWyAtaZO9ZA2zTRxkki2SOXPnP6dIAPN5cmUe16Z7FB4g1TQpfnog6AxIKQVVQNeLgWXa0WpBBWbTq0RZsxcIo5HwprMtDL0cEQbEku72pQoWmFtXbLsUGa6JZ3usHvSZCqa1OkwpukPM1Z8xDBLa56+aCvhMSngnQEO7MpOCugdKFVRiiKXjpwbcnFJBQMhEU6HhKdzwur64T51xR2lVNSeEdhY9Mtqun8lhQohXztyVeRc0YTQkNDEiuTcOprUuY60AlVxK8Alm0kWCqSgOB0iTueEJcFSRMW2VCqu3zXZH9rAddkNvk26vclWtUCvYcrsCjtPw2fgaLNRyAUmbxxt0sY0AqesWAsBOCwB6xLAEPSSwTwMv3YBkQeUiBJat41Vq9UuI5ebzCnllEJshArS4aUJaCKO19say7l+JWPR25SIceSANRJSqljWZtK+Q0TvEdcr4XIFnp8bbjlDtOHxixO+e3/G9+8CzgdrkqsIugTcr4TLlZBvVoykhfH0yHh6G3A6dgQWxPFuY5iPh2wj2MfgwL9/zxexS1ATWjHpUy51+mUsOpvsu/J3sT37HaV25/OKBzL58LYDrQFNGFUItVk6c2kNtTXcBchiv3mMyY399kzlkp0v3hBYjRccGJGAhYEYCClEpOA0LLLpbNjFwPfe7YMNA50qGjkGjiOKMi6147fXG665ItfmzZkixYiHJeDbJ8aXJ2u4IgErm4Y1RRwHhuoAAAYDSURBVALv5EscGBSCo+Bowx8Obryb90QVRYDcFNfacSmCT5eMl0vBi0S8FrZCioHa+7xDD0w4L4x35xXvjgnnqFgBpKjgZNPRcSmHaNKLpmYivFTF803xcul4vgpeb4J7t+3ZaRH86e2K774+4i9fHfDuzDgGAbsZW8iGWX1silQBqQ64CFjighhXoNvZbG27P4eBuTRBLn3wBEzyIlvqoqq9+9TPpU08O0QGecQMoWbqZasFKOBeOz6VhkuueLlllG5QhMdV8dXDgm++fMT7N0c8LoRIFdSacZ9VEWLAcVmwLiYNFRDutaGIbTJrV7TakWtzbbFJskIMSDOFu+OmgntpuBfg3oBbY3zKDS/3ite74lYEqsElqIRIigM1vF0a3h4Tvng84+mQcIoRh0BIQZGivT9G0zOGKDEyYkrgaM9tqYJ7EdyzB9/cMq53G+IZgcWpPrAmFxTmv2MNTdpB2rFExhoDjil6YCIgWlByxeVmA5PcgGvruFbFcxY83wUXUVyK4K6W6aLdNvUWaGdldN9hfFMMGylspoLr1O+PoLng9z+DJrcck8LIZirvviDqupN3epL5Z+jN//eFYE8q6pieDt0FYE3fxt+/fq9jTjEth65lFteb6ozu9UniKDA4zDWrDny4P6tGWugeTgHX01hKo3LyCYNJJLrrxc0wva1d4YieETVMulmbeFySTLvkuA1/NvnWoBkqMrSdYzrDE6iPieKx36HbBTsbDkeSsUWDTnumbnHpPC7wOMyE9n+mEIxnnhJ6N1OT+AU1DkYMESmZ/p2hMxhlYO9EFE06qndkHBJCtBWxtuZaZ9cRRdP7jt9kmIrANH8/EUFvdsgIDArJk728SBQZTj4odEL6J4JtMIenzMOnMGRrwD1bugyyyy5TgIntHOy4qWOFwwAWCtY8uQFmmEzFAw+Mcdw2jaj/YTElm4g5e3kgvkYhHij4VNcLoK4IHVNvK3Zw7QSourvajyKpyZlcjz2MkBsBRHaYoY1jO4OZRKa5b2C5VId9wDFXUKQQwdG69mEGU4iPKtzD0E17bamvYRdWYZ9TRNzR7oU4BrnCEIvJmdOtWoKk9pHGZtM3TPkV0NxzAJcjgAKkA1UaanWCA5sWzwIpPNkSao0Z+3fnU7o1RiyHhOi62riM8CpGqwX3UlxiYGFM6jirGOJEVMJfsE0URawZFSHkZiEVYs450+Dpnp9u0q2ZhtcVMSQscRCE4M9HBUAe3rI42tDkROzFL9Ogu+qmn/UkXmYgMSZmcCbf+WYil4JSCnLOXpSPwBGTXsXEOBxXHJbkpiJbgQayv4kdYVnuGaVUW46yNQWDINGaomSFSjDJCwGtN5SWUeRmiWwGG5zoyd4Z2iNYI5TijuzUQEHAJGBagB6d6uTUFzb9ZOsdVRpytXeV9I2AtcSA5AZpHedYxafcPBNCyYkBMlI7yVGg3dICW7XfXerQA3cErkipY1kUy0J4cz7ji6dHnB8eAIygHrtriEyKGIN7b5wOFMmav+BYTajJBoZ5PcbkU3maetYmVoSTU3tqF6hLUsSpTEbMqlPWNMhSFipinqAlOTaPFL21md9AbiRvXZFLRamC0iwIqTcB+Y2mI9yLed4r3eUqiAEdQC7ZPr/aYCUwIbmJtosj6ODhLmTyiSoVuRa0VmfIWHAtfJOG4tjFPlniTodxaX0kv9NtZI8Aew8sYzsDAo1kYbaiOUbCkqLx0kdAVXfDYO2oIjOJchiDezc9s3jhrQhAcE3vIDV5iJd080l1R5eaJ8a59f69YWjw3WOxbcNtQxaIbLLsgyVRRhHjWzdRBK/lAoxU07bcTt9m7JKv/X20p8AQM3LvXuSapyuwoTB5ICsZM3tiH2rWyaRZDCAREMmHCtPfo0YCc6+MDmKXvyibDP8KvB7aG3a9PORBCPL3m29pOCa/p3XiKtnrv9E6th6QG9u7Qs38KWS/f/daS5U959PVF10Qg0El9ve9+jMonpcw6EOgkYZqfgT+LLVzA2h8xjLHpvyzI/m58XiX3vSZsXJPAdLfBS/9nrm/J1gBwP8AykrUgc5qyQoAAAAASUVORK5CYII=</scrollImg>
    <command name="revert_spell_cmd">
      <pattern>revert #object#</pattern>
      <script>
        if (not HasAttribute(object, "enchanted")) {
          msg ("Nice try, but the object is not enchanted.")
        }
        else {
          foreach (o, AllObjects()) {
            if (StartsWith(object.name, o.name)) {
              if (not object.name = o.name) {
                // msg ("MATCH!")
                obj = o
                o.parent = object.parent
              }
            }
          }
          destroy ("" + object.name + "")
          Log ("Destroyed ")
          msg (obj)
          obj.visible = true
          msg ("You cast the Revert spell on " + GetDisplayName(obj) + ", and it returns to its normal, unenchanted state.")
          obj.enchanted = null
        }
      </script>
    </command>
  </object>
  <object name="room2">
    <inherit name="editor_room" />
    <dark />
    <darkroomdescription><![CDATA[It's pitch dark in here.<br/>]]></darkroomdescription>
    <exit alias="north" to="room">
      <inherit name="northdirection" />
    </exit>
  </object>
  <verb>
    <property>bounce</property>
    <pattern>bounce</pattern>
    <defaultexpression>"You can't bounce " + object.article + "."</defaultexpression>
  </verb>
  <type name="spelltype">
    <drop type="boolean">false</drop>
    <displayverbs type="stringlist">
      <value>Look at</value>
    </displayverbs>
    <inventoryverbs type="stringlist">
      <value>Look at</value>
      <value>Learn</value>
    </inventoryverbs>
    <learn type="script">
      if (not this.parent = game.pov) {
        this.parent = player
        msg ("How about that? You can now cast " + GetDisplayName(this) + ".")
        iv = this.inventoryverbs
        this.inventoryverbs = NewStringList()
        this.inventoryverbs = iv
        list remove (this.inventoryverbs, "Learn")
        foreach (o, AllCommands()) {
          if (o.parent = this) {
            MoveObject (o, null)
          }
        }
      }
      else {
        msg ("Er, you already know that one!")
      }
    </learn>
  </type>
  <type name="scrolltype">
    <inherit name="surface" />
    <feature_container />
    <contentsprefix>written on which there is</contentsprefix>
    <hidechildren />
    <listchildren />
    <displayverbs type="stringlist">
      <value>Look at</value>
      <value>Take</value>
      <value>Copy</value>
    </displayverbs>
    <inventoryverbs type="stringlist">
      <value>Look at</value>
      <value>Copy</value>
    </inventoryverbs>
    <usedefaultprefix type="boolean">false</usedefaultprefix>
    <prefix>the</prefix>
    <take />
    <look type="script">
    </look>
    <copy type="script"><![CDATA[
      foreach (s, GetDirectChildren(this)) {
        if (EndsWith(s.name, "spell")) {
          MoveObject (s, Spell Book)
          sAlias = GetDisplayAlias(s)
          s.listalias = "&nbsp;&nbsp;&nbsp;&nbsp;&nbsp;- " + sAlias + ""
          spellcmd = GetObject(s.name + "_cmd")
          spellcmd.parent = null
          spellcmd.spellName = ListItem(Split(spellcmd.name, "_"), 0)
        }
      }
      RemoveObject (this)
      msg ("You copy the " + sAlias + " to your Spell Book.<br/><br/>The scroll vanishes.<br/>")
    ]]></copy>
  </type>
  <type name="spellbooktype" />
  <walkthrough name="a">
    <steps type="simplestringlist">
      copy Old School Scroll
      copy llorcs
      frotz ball
      lleps frotz
      frotz ball
      lleps frotz
      get the ball
      frotz ball
      s
      lleps frotz
      frotz the ball
      look
      lleps frotz
      frotz ball
      n
      lleps lleps
      lleps frotz
    </steps>
  </walkthrough>
</asl>